Department of Homeland Security, Washington, DC
Open on a drab office with decor dating to the mid-eighties. The DHS assistant to the associate sub-director looks longingly at the office clock nearing five, then leans across the desk and impatiently states his demands:

"First name, last name, pronouns, biographical trivia?"

(1) Ezra Gaunt (he/him), winner of the 2006 Baltimore County Edgar Allan Poe Trivia Competition;

(2) Petula Clark Goldberg (she/her), former award-winning dog trainer of the avant-garde school;

or (3) Larch Faraji (they/them), lead singer of the third-wave-neo-old-school-punk band DC Trash.

1, 2, or 3?

>1
Agent Gaunt is at the south end of the strip mall parking lot. From here one can see just how humble BOSH's state has become: the office, to the west, is between a pawn shop (to the southwest) and a run-down laundromat (to the northwest) and across from an automatic car wash. To the south is a swampy area separating the lot from the interstate. The parking lot continues north.

His Hyundai is parked nearby.

>call bank
You must supply a second noun.

* * *

>scope
1: Gaunt (919344)
2: an office (918128)
3: his Hyundai (918160)
4: a Laundromat-facade (918192)
5: a Pawn-Shop-facade (918224)
6: the Bureau credit card (921008)
7: a green smartphone (921072)

>w
Just like in the store this once was, the door chimes as Gaunt walks in.

Agent Gaunt is in the front office. It's really a small storefront done up to resemble an office. A store sales counter serves as a front desk, behind which are located shelves of office supplies and a row of drawers. There are also a couch and coffee table here creating a makeshift seating area. An old department store clothing rack serves as a coatrack. Photos on the walls picture the Bureau in better days. A stack of used and empty cardboard boxes sits in one corner.

The Bureau's latest office manager, Margaret Chao is bustling around with unrestrained enthusiasm, unpacking boxes and assembling an approximation of a respectable front office, all as if the Bureau isn't going to be shut down before the year is out. She sees Gaunt and practically squeals. "Agent Gaunt! I'm sorry -- Ezra! How are you? I hope you don't mind -- I took the liberty of putting your desk together. I just love hex wrenches, don't you? Also, your new phone is here. I put it in your desk. Good timing! Now I just need you to give me your old phone so I can deactivate it."

Gaunt hands Margaret his old phone. Margaret taps a few keys on her computer and says "There! All settled. Hey, what are you doing for lunch? Let me know when you get hungry!"

A phone is ringing not too far away.

>call bank on phone
You must supply a second noun.

A phone is ringing not too far away.

>call bank
You must supply a second noun.

A phone is ringing not too far away.

* * *

>1
Agent Gaunt is at the south end of the strip mall parking lot. From here one can see just how humble BOSH's state has become: the office, to the west, is between a pawn shop (to the southwest) and a run-down laundromat (to the northwest) and across from an automatic car wash. To the south is a swampy area separating the lot from the interstate. The parking lot continues north.

His Hyundai is parked nearby.

>foo
Faraji is fooing.

Agent Faraji is at the south end of the strip mall parking lot. From here one can see just how humble BOSH's state has become: the office, to the west, is between a pawn shop (to the southwest) and a run-down laundromat (to the northwest) and across from an automatic car wash. To the south is a swampy area separating the lot from the interstate. The parking lot continues north.

Their Hyundai is parked nearby.

They can drive to Marsh Street.

They are fooing.

They are carrying:
  the Bureau credit card
  a green smartphone

* * *

>1
Agent Gaunt is at the south end of the strip mall parking lot. From here one can see just how humble BOSH's state has become: the office, to the west, is between a pawn shop (to the southwest) and a run-down laundromat (to the northwest) and across from an automatic car wash. To the south is a swampy area separating the lot from the interstate. The parking lot continues north.

His Hyundai is parked nearby.

>w
Just like in the store this once was, the door chimes as Gaunt walks in.

Agent Gaunt is in the front office. It's really a small storefront done up to resemble an office. A store sales counter serves as a front desk, behind which are located shelves of office supplies and a row of drawers. There are also a couch and coffee table here creating a makeshift seating area. An old department store clothing rack serves as a coatrack. Photos on the walls picture the Bureau in better days. A stack of used and empty cardboard boxes sits in one corner.

The Bureau's latest office manager, Margaret Chao is bustling around with unrestrained enthusiasm, unpacking boxes and assembling an approximation of a respectable front office, all as if the Bureau isn't going to be shut down before the year is out. She sees Gaunt and practically squeals. "Agent Gaunt! I'm sorry -- Ezra! How are you? I hope you don't mind -- I took the liberty of putting your desk together. I just love hex wrenches, don't you? Also, your new phone is here. I put it in your desk. Good timing! Now I just need you to give me your old phone so I can deactivate it."

Gaunt hands Margaret his old phone. Margaret taps a few keys on her computer and says "There! All settled. Hey, what are you doing for lunch? Let me know when you get hungry!"

A phone is ringing not too far away.

>e
Gaunt steps out of the office into the parking lot.

Agent Gaunt is at the south end of the strip mall parking lot. From here one can see just how humble BOSH's state has become: the office, to the west, is between a pawn shop (to the southwest) and a run-down laundromat (to the northwest) and across from an automatic car wash. To the south is a swampy area separating the lot from the interstate. The parking lot continues north.

His Hyundai is parked nearby.

>n
Gaunt trudges to the other end of the parking lot. It's much like where he left.

Agent Gaunt is at the north end of the strip mall parking lot.. This end is no more auspicious than the other. A convenience store lies to the east. To the west is a military recruitment center. North of here the parking lot exits onto a busy road. There is a rusty sign by the road naming the shopping center: Park Place. South is BOSH headquarters, among other things.

>e
Gaunt is greeted by a blast of music as he enters the store.

Agent Gaunt is in the Li'l Nectarine Convenience Store. Li'l Nectarine offers great service and low prices, or so they say. This one's cluttered aisles and sparse shelves could make one wonder if that's true. Behind the counter is the typical array of cigarettes and lottery tickets. Under the counter is a glass case containing various useful items.

The clerk, a scruffy man in his mid-twenties, is leaning against the counter, looking bored.

>call bank
You don't know the number for bank.

>call bank on phone
You don't know the number for bank on phone.

>talk
(to the Bureau credit card)
The Bureau credit card does not respond.

>talk to man
There's nothing like that nearby.

>talk to clerk
Gaunt says hello to the store clerk.

>ask about clerk
There's nothing like that nearby.

>how are you
Gaunt says "How are you?"

The store clerk replies, "Good, I guess."

>pleased to meet you
That's not a verb I recognise.

>x case
In the glass case are a flashlight, a laptop computer, some wireless earbuds and a black smart phone.

>ask clerk about case
"You want something? Name it."

The store clerk does not respond.

>actions
Actions listing on.

>ask clerk about case
[quizzing the store clerk about the glass case]
"You want something? Name it."

The store clerk does not respond.
[quizzing the store clerk about the glass case - succeeded]

* * *

>w
Gaunt extricates himself from talking with Margaret.

Agent Gaunt is in the hallway. His office is to the south, Klimp's is to the west, and Moira's is to the north. The front office is east.

A phone is ringing to the south.

>e
Agent Gaunt is in the front office. It's really a small storefront done up to resemble an office. A store sales counter serves as a front desk, behind which are located shelves of office supplies and a row of drawers. There are also a couch and coffee table here creating a makeshift seating area. An old department store clothing rack serves as a coatrack. Photos on the walls picture the Bureau in better days. A stack of used and empty cardboard boxes sits in one corner.

The Bureau's latest office manager, Margaret Chao is bustling around with unrestrained enthusiasm.

A phone is ringing not too far away.

>e
Gaunt steps out of the office into the parking lot.

Agent Gaunt is at the south end of the strip mall parking lot. From here one can see just how humble BOSH's state has become: the office, to the west, is between a pawn shop (to the southwest) and a run-down laundromat (to the northwest) and across from an automatic car wash. To the south is a swampy area separating the lot from the interstate. The parking lot continues north.

His Hyundai is parked nearby.

>x car
An old bright red Hyundai Accent, it's been Gaunt's personal means of transportation for years. And since the Bureau lost its fleet, it's his work car too.

>s
The swamp would just muck up Agent Gaunt's clothes.

>e
An automatic car wash isn't of much use when one is on foot.

>sw
Gaunt's not that desperate -- yet.

>nw
A sign on the laundromat door says "Closed for renovations".

>n
Gaunt trudges to the other end of the parking lot. It's much like where he left.

Agent Gaunt is at the north end of the strip mall parking lot.. This end is no more auspicious than the other. A convenience store lies to the east. To the west is a military recruitment center. North of here the parking lot exits onto a busy road. There is a rusty sign by the road naming the shopping center: Park Place. South is BOSH headquarters, among other things.

>w
Gaunt will think about joining the military once the Bureau shuts down.

>e
Gaunt is greeted by a blast of music as he enters the store.

Agent Gaunt is in the Li'l Nectarine Convenience Store. Li'l Nectarine offers great service and low prices, or so they say. This one's cluttered aisles and sparse shelves could make one wonder if that's true. Behind the counter is the typical array of cigarettes and lottery tickets. Under the counter is a glass case containing various useful items.

The clerk, a scruffy man in his mid-twenties, is leaning against the counter, looking bored.

>x case
In the glass case are a flashlight, a laptop computer, some wireless earbuds and a black smart phone.

>buy computer
(with the Bureau credit card)
The store clerk runs the Bureau credit card, but it's declined. You might want to call the bank.

>call bank
I'm not sure what you're trying to say. I might just not recognize the words you're using.

>call bank on phone
I'm not sure what you're trying to say. I might just not recognize the words you're using.

>actions
Actions listing on.

>call bank
I'm not sure what you're trying to say. I might just not recognize the words you're using.

>actions off
Actions listing off.

>trace
[Trace on.]

>call bank
[Parsing for the verb 'call' (2 lines)]
[line 0 * scope=Routine(537149) 'on' noun=Routine(537308) -> A97_calling_it_on]
[line 1 * scope=Routine(537345) 'on' noun=Routine(537504) -> A97_calling_it_on]
I'm not sure what you're trying to say. I might just not recognize the words you're using.

* * *

>2
Agent Goldberg is at the south end of the strip mall parking lot. From here one can see just how humble BOSH's state has become: the office is to the west, between a pawn shop (to the southwest) and a run-down laundromat (to the northwest) and across from an automatic car wash. To the south is a swampy area separating the lot from the interstate. The parking lot continues north.

Her Hyundai is parked nearby.

>gonear hyperplane
Agent Goldberg is on a featureless hyperplane. She rubs her eyes as she tries to take in her surroundings. In addition to the usual directions of north and south and east and west, two new directions exist here: back and forth. As a result, the "surface" she's standing on is in fact a three-dimensional hyperplane. Up and down still exist, and there is gravity, apparently.

As far as one can see, the hyperplane extends infinitely in all six directions, all but featureless.

In the floor (if it can be called that, considering that it extends in six directions from here) floats a set of ethereal symbols:  :  : 

Far off in the distance is some kind of structure, roughly to the forth.

>f
Agent Goldberg is on a featureless hyperplane.  In addition to the usual directions of north and south and east and west, two new directions exist here: back and forth. As a result, the "surface" she's standing on is in fact a three-dimensional hyperplane. Up and down still exist, and there is gravity, apparently.

As far as one can see, the hyperplane extends infinitely in all six directions, all but featureless.

In the floor (if it can be called that, considering that it extends in six directions from here) floats a set of ethereal symbols:  :  : 

Far off in the distance is some kind of structure, roughly to the forth.

>f
Agent Goldberg is on a featureless hyperplane.  In addition to the usual directions of north and south and east and west, two new directions exist here: back and forth. As a result, the "surface" she's standing on is in fact a three-dimensional hyperplane. Up and down still exist, and there is gravity, apparently.

As far as one can see, the hyperplane extends infinitely in all six directions, all but featureless.

In the floor (if it can be called that, considering that it extends in six directions from here) floats a set of ethereal symbols:  :  : 

Far off in the distance is some kind of structure, roughly to the forth.

>f
Agent Goldberg is on a featureless hyperplane.  In addition to the usual directions of north and south and east and west, two new directions exist here: back and forth. As a result, the "surface" she's standing on is in fact a three-dimensional hyperplane. Up and down still exist, and there is gravity, apparently.

As far as one can see, the hyperplane extends infinitely in all six directions, all but featureless.

In the floor (if it can be called that, considering that it extends in six directions from here) floats a set of ethereal symbols:  :  : 

Far off in the distance is some kind of structure, roughly to the forthnorth.

>fn
Agent Goldberg is on a featureless hyperplane.  In addition to the usual directions of north and south and east and west, two new directions exist here: back and forth. As a result, the "surface" she's standing on is in fact a three-dimensional hyperplane. Up and down still exist, and there is gravity, apparently.

As far as one can see, the hyperplane extends infinitely in all six directions, all but featureless.

In the floor (if it can be called that, considering that it extends in six directions from here) floats a set of ethereal symbols:  :  : 

Far off in the distance is some kind of structure, roughly to the forthwest.

>fw
Agent Goldberg is on a featureless hyperplane.  In addition to the usual directions of north and south and east and west, two new directions exist here: back and forth. As a result, the "surface" she's standing on is in fact a three-dimensional hyperplane. Up and down still exist, and there is gravity, apparently.

As far as one can see, the hyperplane extends infinitely in all six directions, all but featureless.

In the floor (if it can be called that, considering that it extends in six directions from here) floats a set of ethereal symbols:  :  : 

In the middle distance is some kind of structure, roughly to the forthnorth.

>fn
Agent Goldberg is on a featureless hyperplane.  In addition to the usual directions of north and south and east and west, two new directions exist here: back and forth. As a result, the "surface" she's standing on is in fact a three-dimensional hyperplane. Up and down still exist, and there is gravity, apparently.

As far as one can see, the hyperplane extends infinitely in all six directions, all but featureless.

In the floor (if it can be called that, considering that it extends in six directions from here) floats a set of ethereal symbols:  :  : 

In the middle distance is some kind of structure, roughly to the forthnorth.

>fn
Agent Goldberg is on a featureless hyperplane.  In addition to the usual directions of north and south and east and west, two new directions exist here: back and forth. As a result, the "surface" she's standing on is in fact a three-dimensional hyperplane. Up and down still exist, and there is gravity, apparently.

As far as one can see, the hyperplane extends infinitely in all six directions, all but featureless.

In the floor (if it can be called that, considering that it extends in six directions from here) floats a set of ethereal symbols:  :  : 

Not too far off is some kind of structure, roughly to the forthwest.

>fw
Agent Goldberg is on a featureless hyperplane.  In addition to the usual directions of north and south and east and west, two new directions exist here: back and forth. As a result, the "surface" she's standing on is in fact a three-dimensional hyperplane. Up and down still exist, and there is gravity, apparently.

As far as one can see, the hyperplane extends infinitely in all six directions, all but featureless.

In the floor (if it can be called that, considering that it extends in six directions from here) floats a set of ethereal symbols:  :  : 

Not too far off is some kind of structure, roughly to the west.

>w
Agent Goldberg is on a featureless hyperplane.  In addition to the usual directions of north and south and east and west, two new directions exist here: back and forth. As a result, the "surface" she's standing on is in fact a three-dimensional hyperplane. Up and down still exist, and there is gravity, apparently.

As far as one can see, the hyperplane extends infinitely in all six directions, all but featureless.

In the floor (if it can be called that, considering that it extends in six directions from here) floats a set of ethereal symbols:  :  : 

Not too far off is some kind of structure, roughly to the forthnorth.

>fn
Agent Goldberg is on a featureless hyperplane.  In addition to the usual directions of north and south and east and west, two new directions exist here: back and forth. As a result, the "surface" she's standing on is in fact a three-dimensional hyperplane. Up and down still exist, and there is gravity, apparently.

As far as one can see, the hyperplane extends infinitely in all six directions, all but featureless.

In the floor (if it can be called that, considering that it extends in six directions from here) floats a set of ethereal symbols:  :  : 

Close by is some kind of structure to the west.

>w
Agent Goldberg is next to an ethereal pillar.  In addition to the usual directions of north and south and east and west, two new directions exist here: back and forth. As a result, the "surface" she's standing on is in fact a three-dimensional hyperplane. Up and down still exist, and there is gravity, apparently.

As far as one can see, the hyperplane extends infinitely in all six directions, all but featureless.

There is an ethereal pillar here, carved with puzzling shapes:

 O---------O
  | | | | |
  | | | | |
  | | | | |
  | | | | |
  ---------
 (    )
  ---------
  | | | | |
  ||-----||
  ||  ||
  ||   ||
  ||   ||
  ||-----||
  | | | | |
  | | | | |
 /---------\

In the floor (if it can be called that, considering that it extends in six directions from here) floats a set of ethereal symbols:  :  :

>b
Agent Goldberg is on a featureless hyperplane.  In addition to the usual directions of north and south and east and west, two new directions exist here: back and forth. As a result, the "surface" she's standing on is in fact a three-dimensional hyperplane. Up and down still exist, and there is gravity, apparently.

As far as one can see, the hyperplane extends infinitely in all six directions, all but featureless.

In the floor (if it can be called that, considering that it extends in six directions from here) floats a set of ethereal symbols:  :  : 

Close by is some kind of structure to the forth.

>b
Agent Goldberg is on a featureless hyperplane.  In addition to the usual directions of north and south and east and west, two new directions exist here: back and forth. As a result, the "surface" she's standing on is in fact a three-dimensional hyperplane. Up and down still exist, and there is gravity, apparently.

As far as one can see, the hyperplane extends infinitely in all six directions, all but featureless.

In the floor (if it can be called that, considering that it extends in six directions from here) floats a set of ethereal symbols:  :  : 

Close by is some kind of structure to the forth.

>w
Agent Goldberg is on a featureless hyperplane.  In addition to the usual directions of north and south and east and west, two new directions exist here: back and forth. As a result, the "surface" she's standing on is in fact a three-dimensional hyperplane. Up and down still exist, and there is gravity, apparently.

As far as one can see, the hyperplane extends infinitely in all six directions, all but featureless.

In the floor (if it can be called that, considering that it extends in six directions from here) floats a set of ethereal symbols:  :  : 

Close by is some kind of structure to the forth.

>w
Agent Goldberg is on a featureless hyperplane.  In addition to the usual directions of north and south and east and west, two new directions exist here: back and forth. As a result, the "surface" she's standing on is in fact a three-dimensional hyperplane. Up and down still exist, and there is gravity, apparently.

As far as one can see, the hyperplane extends infinitely in all six directions, all but featureless.

In the floor (if it can be called that, considering that it extends in six directions from here) floats a set of ethereal symbols:  :  : 

Not too far off is some kind of structure, roughly to the forth.

>w
Agent Goldberg is on a featureless hyperplane.  In addition to the usual directions of north and south and east and west, two new directions exist here: back and forth. As a result, the "surface" she's standing on is in fact a three-dimensional hyperplane. Up and down still exist, and there is gravity, apparently.

As far as one can see, the hyperplane extends infinitely in all six directions, all but featureless.

In the floor (if it can be called that, considering that it extends in six directions from here) floats a set of ethereal symbols:  :  : 

Not too far off is some kind of structure, roughly to the fortheast.

>w
Agent Goldberg is on a featureless hyperplane.  In addition to the usual directions of north and south and east and west, two new directions exist here: back and forth. As a result, the "surface" she's standing on is in fact a three-dimensional hyperplane. Up and down still exist, and there is gravity, apparently.

As far as one can see, the hyperplane extends infinitely in all six directions, all but featureless.

In the floor (if it can be called that, considering that it extends in six directions from here) floats a set of ethereal symbols:  :  : 

Not too far off is some kind of structure, roughly to the fortheast.

>s
Agent Goldberg is on a featureless hyperplane.  In addition to the usual directions of north and south and east and west, two new directions exist here: back and forth. As a result, the "surface" she's standing on is in fact a three-dimensional hyperplane. Up and down still exist, and there is gravity, apparently.

As far as one can see, the hyperplane extends infinitely in all six directions, all but featureless.

In the floor (if it can be called that, considering that it extends in six directions from here) floats a set of ethereal symbols:  :  : 

In the middle distance is some kind of structure, roughly to the fortheast.

>s
Agent Goldberg is on a featureless hyperplane.  In addition to the usual directions of north and south and east and west, two new directions exist here: back and forth. As a result, the "surface" she's standing on is in fact a three-dimensional hyperplane. Up and down still exist, and there is gravity, apparently.

As far as one can see, the hyperplane extends infinitely in all six directions, all but featureless.

In the floor (if it can be called that, considering that it extends in six directions from here) floats a set of ethereal symbols:  :  : 

In the middle distance is some kind of structure, roughly to the fortheast.

>s
Agent Goldberg is on a featureless hyperplane.  In addition to the usual directions of north and south and east and west, two new directions exist here: back and forth. As a result, the "surface" she's standing on is in fact a three-dimensional hyperplane. Up and down still exist, and there is gravity, apparently.

As far as one can see, the hyperplane extends infinitely in all six directions, all but featureless.

In the floor (if it can be called that, considering that it extends in six directions from here) floats a set of ethereal symbols:  :  : 

Far off in the distance is some kind of structure, roughly to the northeast.

>s
Agent Goldberg is on a featureless hyperplane.  In addition to the usual directions of north and south and east and west, two new directions exist here: back and forth. As a result, the "surface" she's standing on is in fact a three-dimensional hyperplane. Up and down still exist, and there is gravity, apparently.

As far as one can see, the hyperplane extends infinitely in all six directions, all but featureless.

In the floor (if it can be called that, considering that it extends in six directions from here) floats a set of ethereal symbols:  :  : 

Far off in the distance is some kind of structure, roughly to the northeast.

>s
Agent Goldberg is on a featureless hyperplane.  In addition to the usual directions of north and south and east and west, two new directions exist here: back and forth. As a result, the "surface" she's standing on is in fact a three-dimensional hyperplane. Up and down still exist, and there is gravity, apparently.

As far as one can see, the hyperplane extends infinitely in all six directions, all but featureless.

In the floor (if it can be called that, considering that it extends in six directions from here) floats a set of ethereal symbols:  :  : 

Far off in the distance is some kind of structure, roughly to the north.

>s
Agent Goldberg is on a featureless hyperplane.  In addition to the usual directions of north and south and east and west, two new directions exist here: back and forth. As a result, the "surface" she's standing on is in fact a three-dimensional hyperplane. Up and down still exist, and there is gravity, apparently.

As far as one can see, the hyperplane extends infinitely in all six directions, all but featureless.

In the floor (if it can be called that, considering that it extends in six directions from here) floats a set of ethereal symbols:  :  : 

Far off in the distance is some kind of structure, roughly to the north.

>s
Agent Goldberg is at the top of a descending stair.  In addition to the usual directions of north and south and east and west, two new directions exist here: back and forth. As a result, the "surface" she's standing on is in fact a three-dimensional hyperplane. Up and down still exist, and there is gravity, apparently.

As far as one can see, the hyperplane extends infinitely in all six directions, all but featureless.

A spiraling staircase disappears into the ground here. It is made of the same gossamer, questionably real stuff as the ground, the pillar, and the readouts. You can't see past the first turn of the stairs, unfortunately.

In the floor (if it can be called that, considering that it extends in six directions from here) floats a set of ethereal symbols:  :  : 

Far off in the distance is some kind of structure, roughly to the north.

>s
Agent Goldberg is on a featureless hyperplane.  In addition to the usual directions of north and south and east and west, two new directions exist here: back and forth. As a result, the "surface" she's standing on is in fact a three-dimensional hyperplane. Up and down still exist, and there is gravity, apparently.

As far as one can see, the hyperplane extends infinitely in all six directions, all but featureless.

In the floor (if it can be called that, considering that it extends in six directions from here) floats a set of ethereal symbols:  :  : 

Far off in the distance is some kind of structure, roughly to the north.

>n
Agent Goldberg is at the top of a descending stair.  In addition to the usual directions of north and south and east and west, two new directions exist here: back and forth. As a result, the "surface" she's standing on is in fact a three-dimensional hyperplane. Up and down still exist, and there is gravity, apparently.

As far as one can see, the hyperplane extends infinitely in all six directions, all but featureless.

A spiraling staircase disappears into the ground here. It is made of the same gossamer, questionably real stuff as the ground, the pillar, and the readouts. You can't see past the first turn of the stairs, unfortunately.

In the floor (if it can be called that, considering that it extends in six directions from here) floats a set of ethereal symbols:  :  : 

Far off in the distance is some kind of structure, roughly to the north.

>d
Agent Goldberg is at the bottom of the staircase. Hooray you made it!

>u
Agent Goldberg is at the top of a descending stair.  In addition to the usual directions of north and south and east and west, two new directions exist here: back and forth. As a result, the "surface" she's standing on is in fact a three-dimensional hyperplane. Up and down still exist, and there is gravity, apparently.

As far as one can see, the hyperplane extends infinitely in all six directions, all but featureless.

A spiraling staircase disappears into the ground here. It is made of the same gossamer, questionably real stuff as the ground, the pillar, and the readouts. You can't see past the first turn of the stairs, unfortunately.

In the floor (if it can be called that, considering that it extends in six directions from here) floats a set of ethereal symbols:  :  : 

Far off in the distance is some kind of structure, roughly to the north.

>x stair
There seems to be nothing special about it.

>x pillar
There's nothing like that nearby.

* * *

>2
Agent Goldberg is at the south end of the strip mall parking lot. From here one can see just how humble BOSH's state has become: the office is to the west, between a pawn shop (to the southwest) and a run-down laundromat (to the northwest) and across from an automatic car wash. To the south is a swampy area separating the lot from the interstate. The parking lot continues north.

Her Hyundai is parked nearby.

>foo
Goldberg is fooing.

Agent Goldberg is at the south end of the strip mall parking lot. From here one can see just how humble BOSH's state has become: the office, to the west, is between a pawn shop (to the southwest) and a run-down laundromat (to the northwest) and across from an automatic car wash. To the south is a swampy area separating the lot from the interstate. The parking lot continues north.

Her Hyundai is parked nearby.

She can drive to Marsh Street.

She is fooing.

She is carrying:
  the Bureau credit card
  a green smartphone

* * *

>2
Agent Goldberg is at the south end of the strip mall parking lot. From here one can see just how humble BOSH's state has become: the office is to the west, between a pawn shop (to the southwest) and a run-down laundromat (to the northwest) and across from an automatic car wash. To the south is a swampy area separating the lot from the interstate. The parking lot continues north.

Her Hyundai is parked nearby.

>l
Agent Goldberg is at the south end of the strip mall parking lot. From here one can see just how humble BOSH's state has become: the office, to the west, is between a pawn shop (to the southwest) and a run-down laundromat (to the northwest) and across from an automatic car wash. To the south is a swampy area separating the lot from the interstate. The parking lot continues north.

Her Hyundai is parked nearby.

She can drive to Marsh Street.

>i
Goldberg is carrying:
  the Bureau credit card
  a green smartphone

>x laundromat
Goldberg peers through the windows of the laundromat at the rows of aging machines. A sign on the door says "Closed for renovations". She turns away, unimpressed.

* * *

>2
Agent Goldberg is at the south end of the strip mall parking lot. From here one can see just how humble BOSH's state has become: the office is to the west, between a pawn shop (to the southwest) and a run-down laundromat (to the northwest) and across from an automatic car wash. To the south is a swampy area separating the lot from the interstate. The parking lot continues north.

Her Hyundai is parked nearby.

>n
Goldberg trudges to the other end of the parking lot. It's much like where she left.

Agent Goldberg is at the north end of the strip mall parking lot.. This end is no more auspicious than the other. A convenience store lies to the east. To the west is a military recruitment center. North of here the parking lot exits onto a busy road. There is a rusty sign by the road naming the shopping center: Park Place. South is BOSH headquarters, among other things.

>e
Goldberg is greeted by a blast of music as she enters the store.

Agent Goldberg is in the Li'l Nectarine Convenience Store. Li'l Nectarine offers great service and low prices, or so they say. This one's cluttered aisles and sparse shelves could make one wonder if that's true. Behind the counter is the typical array of cigarettes and lottery tickets. Under the counter is a glass case containing various useful items.

The clerk, a scruffy man in his mid-twenties, is leaning against the counter, looking bored.

>ask man about case
There's nothing like that nearby.

>ask clerk about case
"You want something? Name it."

>x case
In the glass case are a flashlight, a red screwdriver, a laptop computer, some wireless earbuds and a black smart phone.

>ask clerk about screwdriver
That is not a topic of conversation at the moment.

>ask clerk for screwdriver
That is not a topic of conversation at the moment.

>buy screwdriver
(with the Bureau credit card)
No one owns that.

* * *

>2
Agent Goldberg is at the south end of the strip mall parking lot. From here one can see just how humble BOSH's state has become: the office is to the west, between a pawn shop (to the southwest) and a run-down laundromat (to the northwest) and across from an automatic car wash. To the south is a swampy area separating the lot from the interstate. The parking lot continues north.

Her Hyundai is parked nearby.

>w
Just like in the store this once was, the door chimes as Goldberg walks in.

Agent Goldberg is in the front office. It's really a small storefront done up to resemble an office. A store sales counter serves as a front desk, behind which are located shelves of office supplies and a row of drawers. There are also a couch and coffee table here creating a makeshift seating area. An old department store clothing rack serves as a coatrack. Photos on the walls picture the Bureau in better days. A stack of used and empty cardboard boxes sits in one corner.

The Bureau's latest office manager, Margaret Chao is bustling around with unrestrained enthusiasm, unpacking boxes and assembling an approximation of a respectable front office, all as if the Bureau isn't going to be shut down before the year is out. It sees Goldberg and practically squeals. "Agent Goldberg! I'm sorry -- Petula! How are you? I hope you don't mind -- I took the liberty of putting your desk together. I just love hex wrenches, don't you? Also, your new phone is here. I put it in your desk. Good timing! Now I just need you to give me your old phone so I can deactivate it."

Goldberg hands Margaret her old phone. Margaret taps a few keys on her computer and says "There! All settled. Hey, what are you doing for lunch? Let me know when you get hungry!"

A phone is ringing not too far away.

>drop all
(the Bureau credit card)
Dropped.

A phone is ringing not too far away.

>i
Goldberg is carrying nothing. She is carrying nothing.

A phone is ringing not too far away.

* * *

>say hi
Goldberg is already talking to Margaret.

A phone is ringing not too far away.

>how are you
Goldberg says "How are you, Margaret?"

Margaret replies, "I'm great! Thanks!"

A phone is ringing not too far away.

>w
Goldberg extricates herself from talking with Margaret.

Agent Goldberg is in the hallway. Her office is to the south, Klimp's is to the west, and Moira's is to the north. The front office is east.

A phone is ringing to the south.

>s
Agent Goldberg is in her office. She pauses and surveys the scene. It's not much -- four white walls, grey industrial carpet. Margaret has helpfully assembled Goldberg's desk and chair, though how sturdily is an open question. She also took the time to put up some of Agent Goldberg's office decor -- her degree in Nonstandard Investigative Techniques, a photo of her dog Pluto, and a print of Green Pheasant by Utagawa Hiroshige. At the very least the wall coverings help compensate for the lack of windows. There's a disconnected landline on the desk. The office door is to the north, and there's a white metal door to the west.

Goldberg mutters, "Where's my computer?"

A phone is ringing inside her desk.

>open desk
Goldberg tries to open the desk to answer the phone, but it seems to be locked. She sighs. "Margaret must have the key."

A phone is ringing inside her desk.

>take phone
The Federal government frowns upon employees taking office equipment home with them.

A phone is ringing inside Goldberg's desk.

>answer phone
There's nothing like that nearby.

>w
(first opening the white metal door)
It seems to be locked.

A phone is ringing inside Goldberg's desk.

>n
Agent Goldberg is in the hallway. Her office is to the south, Klimp's is to the west, and Moira's is to the north. The front office is east.

A phone is ringing to the south.

>e
Agent Goldberg is in the front office. It's really a small storefront done up to resemble an office. A store sales counter serves as a front desk, behind which are located shelves of office supplies and a row of drawers. There are also a couch and coffee table here creating a makeshift seating area. An old department store clothing rack serves as a coatrack. Photos on the walls picture the Bureau in better days. A stack of used and empty cardboard boxes sits in one corner.

The Bureau's latest office manager, Margaret Chao is bustling around with unrestrained enthusiasm, unpacking boxes and assembling an approximation of a respectable front office, all as if the Bureau isn't going to be shut down before the year is out.

A phone is ringing not too far away.

She can ask about the whereabouts of the desk key, ask about the status of the computer or ask to unlock the backdoor.

>ask about key
Goldberg says, "Margaret, sweetheart, do you know where my desk key is?"

"Sure I do -- I put it in your desk." She furrows her brow. "What's the matter?"

A phone is ringing not too far away.

She can ask about the status of the computer or ask to unlock the backdoor.

* * *

>w
Goldberg extricates herself from talking with Margaret.

Agent Goldberg is in the hallway. Her office is to the south, Klimp's is to the west, and Moira's is to the north. The front office is east.

A phone is ringing to the south.

>drop all
(the Bureau credit card)
Dropped.

A phone is ringing to the south.

>foo
Agent Goldberg is in the hallway. Her office is to the south, Klimp's is to the west, and Moira's is to the north. The front office is east.

Also here is the Bureau credit card.

She is carrying nothing.

A phone is ringing to the south.

>s
Agent Goldberg is in her office. She pauses and surveys the scene. It's not much -- four white walls, grey industrial carpet. Margaret has helpfully assembled Goldberg's desk and chair, though how sturdily is an open question. She also took the time to put up some of Agent Goldberg's office decor -- her degree in Nonstandard Investigative Techniques, a photo of her dog Pluto, and a print of Green Pheasant by Utagawa Hiroshige. At the very least the wall coverings help compensate for the lack of windows. There's a disconnected landline on the desk. The office door is to the north, and there's a white metal door to the west.

Goldberg mutters, "Where's my computer?"

A phone is ringing inside her desk.

>foo
Agent Goldberg is in her office. It's basically four white walls and grey carpet. There's a cheap desk and chair, and a disconnected phone on the desk. In lieu of windows, there are a few things on the wall: her degree in Nonstandard Investigative Techniques, a photo of her dog Pluto, and a Japanese print. The office door is to the north, and there's a white metal door to the west.

She is carrying nothing.

A phone is ringing inside her desk.

>n
Agent Goldberg is in the hallway. Her office is to the south, Klimp's is to the west, and Moira's is to the north. The front office is east.

Also here is the Bureau credit card.

A phone is ringing to the south.

>e
Agent Goldberg is in the front office. It's really a small storefront done up to resemble an office. A store sales counter serves as a front desk, behind which are located shelves of office supplies and a row of drawers. There are also a couch and coffee table here creating a makeshift seating area. An old department store clothing rack serves as a coatrack. Photos on the walls picture the Bureau in better days. A stack of used and empty cardboard boxes sits in one corner.

The Bureau's latest temporary worker, Margaret is bustling around with unrestrained enthusiasm, unpacking boxes and assembling an approximation of a respectable front office, all as if the Bureau isn't going to be shut down before the year is out.

A phone is ringing not too far away.

Goldberg can ask about the status of the computer.

>e
Goldberg steps out of the office into the parking lot.

Agent Goldberg is at the south end of the strip mall parking lot. From here one can see just how humble BOSH's state has become: the office, to the west, is between a pawn shop (to the southwest) and a run-down laundromat (to the northwest) and across from an automatic car wash. To the south is a swampy area separating the lot from the interstate. The parking lot continues north.

Her Hyundai is parked nearby.

She can drive to Marsh Street.

>foo
Agent Goldberg is at the south end of the strip mall parking lot. From here one can see just how humble BOSH's state has become: the office, to the west, is between a pawn shop (to the southwest) and a run-down laundromat (to the northwest) and across from an automatic car wash. To the south is a swampy area separating the lot from the interstate. The parking lot continues north.

Her Hyundai is parked nearby.

She can drive to Marsh Street.

She is carrying nothing.

* * *

>3
Agent Faraji is at the south end of the strip mall parking lot. From here one can see just how humble BOSH's state has become: the office is to the west, between a pawn shop (to the southwest) and a run-down laundromat (to the northwest) and across from an automatic car wash. To the south is a swampy area separating the lot from the interstate. The parking lot continues north.

Their Hyundai is parked nearby.

>n
Faraji trudges to the other end of the parking lot. It's much like where they left.

Agent Faraji is at the north end of the strip mall parking lot.. This end is no more auspicious than the other. A convenience store lies to the east. To the west is a military recruitment center. North of here the parking lot exits onto a busy road. There is a rusty sign by the road naming the shopping center: Park Place. South is BOSH headquarters, among other things.

>e
Faraji is greeted by a blast of music as they enter the store.

Agent Faraji is in the Li'l Nectarine Convenience Store. Li'l Nectarine offers great service and low prices, or so they say. This one's cluttered aisles and sparse shelves could make one wonder if that's true. Behind the counter is the typical array of cigarettes and lottery tickets. Under the counter is a glass case containing various useful items.

The clerk, a scruffy man in his mid-twenties, is leaning against the counter, looking bored.

>x case
In the glass case are a flashlight, a red screwdriver, a laptop computer, some wireless earbuds and a black smart phone.

>ask about screwdriver
That is not a topic of conversation at the moment.

>ask about computer
That is not a topic of conversation at the moment.

>buy computer
(with the Bureau credit card)
The store clerk runs the Bureau credit card, but it's declined. You might want to call the bank.

>gonear hyperplane
Agent Faraji is on a featureless hyperplane. They rub their eyes as they try to take in their surroundings. In addition to the usual directions of north and south and east and west, two new directions exist here: back and forth. As a result, the "surface" they're standing on is in fact a three-dimensional hyperplane. Up and down still exist, and there is gravity, apparently.

As far as one can see, the hyperplane extends infinitely in all six directions, all but featureless.

In the floor (if it can be called that, considering that it extends in six directions from here) floats a set of ethereal symbols:   

Far off in the distance is some kind of structure, roughly to the forth.

>f
Agent Faraji is on a featureless hyperplane.  In addition to the usual directions of north and south and east and west, two new directions exist here: back and forth. As a result, the "surface" they're standing on is in fact a three-dimensional hyperplane. Up and down still exist, and there is gravity, apparently.

As far as one can see, the hyperplane extends infinitely in all six directions, all but featureless.

In the floor (if it can be called that, considering that it extends in six directions from here) floats a set of ethereal symbols:   

Far off in the distance is some kind of structure, roughly to the forth.

>f
Agent Faraji is on a featureless hyperplane.  In addition to the usual directions of north and south and east and west, two new directions exist here: back and forth. As a result, the "surface" they're standing on is in fact a three-dimensional hyperplane. Up and down still exist, and there is gravity, apparently.

As far as one can see, the hyperplane extends infinitely in all six directions, all but featureless.

In the floor (if it can be called that, considering that it extends in six directions from here) floats a set of ethereal symbols:   

Far off in the distance is some kind of structure, roughly to the forth.

>f
Agent Faraji is on a featureless hyperplane.  In addition to the usual directions of north and south and east and west, two new directions exist here: back and forth. As a result, the "surface" they're standing on is in fact a three-dimensional hyperplane. Up and down still exist, and there is gravity, apparently.

As far as one can see, the hyperplane extends infinitely in all six directions, all but featureless.

In the floor (if it can be called that, considering that it extends in six directions from here) floats a set of ethereal symbols:   

Far off in the distance is some kind of structure, roughly to the forthnorth.

>fn
Agent Faraji is on a featureless hyperplane.  In addition to the usual directions of north and south and east and west, two new directions exist here: back and forth. As a result, the "surface" they're standing on is in fact a three-dimensional hyperplane. Up and down still exist, and there is gravity, apparently.

As far as one can see, the hyperplane extends infinitely in all six directions, all but featureless.

In the floor (if it can be called that, considering that it extends in six directions from here) floats a set of ethereal symbols:   

Far off in the distance is some kind of structure, roughly to the forthwest.

>fw
Agent Faraji is on a featureless hyperplane.  In addition to the usual directions of north and south and east and west, two new directions exist here: back and forth. As a result, the "surface" they're standing on is in fact a three-dimensional hyperplane. Up and down still exist, and there is gravity, apparently.

As far as one can see, the hyperplane extends infinitely in all six directions, all but featureless.

In the floor (if it can be called that, considering that it extends in six directions from here) floats a set of ethereal symbols:   

In the middle distance is some kind of structure, roughly to the forthnorth.

>fn
Agent Faraji is on a featureless hyperplane.  In addition to the usual directions of north and south and east and west, two new directions exist here: back and forth. As a result, the "surface" they're standing on is in fact a three-dimensional hyperplane. Up and down still exist, and there is gravity, apparently.

As far as one can see, the hyperplane extends infinitely in all six directions, all but featureless.

In the floor (if it can be called that, considering that it extends in six directions from here) floats a set of ethereal symbols:   

In the middle distance is some kind of structure, roughly to the forthnorth.

>fn
Agent Faraji is on a featureless hyperplane.  In addition to the usual directions of north and south and east and west, two new directions exist here: back and forth. As a result, the "surface" they're standing on is in fact a three-dimensional hyperplane. Up and down still exist, and there is gravity, apparently.

As far as one can see, the hyperplane extends infinitely in all six directions, all but featureless.

In the floor (if it can be called that, considering that it extends in six directions from here) floats a set of ethereal symbols:   

Not too far off is some kind of structure, roughly to the forthwest.

>fw
Agent Faraji is on a featureless hyperplane.  In addition to the usual directions of north and south and east and west, two new directions exist here: back and forth. As a result, the "surface" they're standing on is in fact a three-dimensional hyperplane. Up and down still exist, and there is gravity, apparently.

As far as one can see, the hyperplane extends infinitely in all six directions, all but featureless.

In the floor (if it can be called that, considering that it extends in six directions from here) floats a set of ethereal symbols:   

Not too far off is some kind of structure, roughly to the west.

>w
Agent Faraji is on a featureless hyperplane.  In addition to the usual directions of north and south and east and west, two new directions exist here: back and forth. As a result, the "surface" they're standing on is in fact a three-dimensional hyperplane. Up and down still exist, and there is gravity, apparently.

As far as one can see, the hyperplane extends infinitely in all six directions, all but featureless.

In the floor (if it can be called that, considering that it extends in six directions from here) floats a set of ethereal symbols:   

Not too far off is some kind of structure, roughly to the forthnorth.

>fn
Agent Faraji is on a featureless hyperplane.  In addition to the usual directions of north and south and east and west, two new directions exist here: back and forth. As a result, the "surface" they're standing on is in fact a three-dimensional hyperplane. Up and down still exist, and there is gravity, apparently.

As far as one can see, the hyperplane extends infinitely in all six directions, all but featureless.

In the floor (if it can be called that, considering that it extends in six directions from here) floats a set of ethereal symbols:   

Close by is some kind of structure to the west.

>w
Agent Faraji is next to an ethereal pillar.  In addition to the usual directions of north and south and east and west, two new directions exist here: back and forth. As a result, the "surface" they're standing on is in fact a three-dimensional hyperplane. Up and down still exist, and there is gravity, apparently.

As far as one can see, the hyperplane extends infinitely in all six directions, all but featureless.

There is an ethereal pillar here, carved with puzzling shapes:

 O---------O
  | | | | |
  | | | | |
  | | | | |
  | | | | |
  ---------
 (    )
  ---------
  | | | | |
  ||-----||
  ||  ||
  ||   ||
  ||   ||
  ||-----||
  | | | | |
  | | | | |
 /---------\

In the floor (if it can be called that, considering that it extends in six directions from here) floats a set of ethereal symbols:

>restart
Are you sure you want to restart?

>y
Department of Homeland Security, Washington, DC
Open on a drab office with decor dating to the mid-eighties. The DHS assistant to the associate sub-director looks longingly at the office clock nearing five, then leans across the desk and impatiently states his demands:

"First name, last name, pronouns, biographical trivia?"

(1) Ezra Gaunt (he/him), winner of the 2006 Baltimore County Edgar Allan Poe Trivia Competition;

(2) Petula Clark Goldberg (she/her), former award-winning dog trainer of the avant-garde school;

or (3) Larch Faraji (they/them), lead singer of the third-wave-neo-old-school-punk band DC Trash.

1, 2, or 3?

>3
Agent Faraji is at the south end of the strip mall parking lot. From here one can see just how humble BOSH's state has become: the office is to the west, between a pawn shop (to the southwest) and a run-down laundromat (to the northwest) and across from an automatic car wash. To the south is a swampy area separating the lot from the interstate. The parking lot continues north.

Their Hyundai is parked nearby.

>gonear hyperplane
Agent Faraji is on a featureless hyperplane. They rub their eyes as they try to take in their surroundings. In addition to the usual directions of north and south and east and west, two new directions exist here: back and forth. As a result, the "surface" they're standing on is in fact a three-dimensional hyperplane. Up and down still exist, and there is gravity, apparently.

As far as one can see, the hyperplane extends infinitely in all six directions, all but featureless.

In the floor (if it can be called that, considering that it extends in six directions from here) floats a set of ethereal symbols:   

Far off in the distance is some kind of structure, roughly to the forth.

* * *

>3
Agent Faraji is at the south end of the strip mall parking lot. From here one can see just how humble BOSH's state has become: the office is to the west, between a pawn shop (to the southwest) and a run-down laundromat (to the northwest) and across from an automatic car wash. To the south is a swampy area separating the lot from the interstate. The parking lot continues north.

Their Hyundai is parked nearby.

>w
Just like in the store this once was, the door chimes as Faraji walks in.

Agent Faraji is in the front office. It's really a small storefront done up to resemble an office. A store sales counter serves as a front desk, behind which are located shelves of office supplies and a row of drawers. There are also a couch and coffee table here creating a makeshift seating area. An old department store clothing rack serves as a coatrack. Photos on the walls picture the Bureau in better days. A stack of used and empty cardboard boxes sits in one corner.

The Bureau's latest temporary worker, Margaret is bustling around with unrestrained enthusiasm, unpacking boxes and assembling an approximation of a respectable front office, all as if the Bureau isn't going to be shut down before the year is out. She sees Faraji and practically squeals. "Larch! I'm sorry -- Agent Faraji! How are you? I hope you don't mind -- I took the liberty of putting your desk together. I just love hex wrenches, don't you? Also, your new phone is here. I put it in your desk. Good timing! Now I just need you to give me your old phone so I can deactivate it."

Faraji hands Margaret their old phone. Margaret taps a few keys on her computer and says "There! All settled. Hey, what are you doing for lunch? Let me know when you get hungry!"

A phone is ringing not too far away.

>ask about klimp
There's nothing like that nearby.

>ask margaret about margaret
Margaret does not respond.

A phone is ringing not too far away.

>w
Faraji extricates themself from talking with Margaret.

Agent Faraji is in the hallway. Their office is to the south, Klimp's is to the west, and Moira's is to the north. The front office is east.

A phone is ringing to the south.

>s
Agent Faraji is in their office. They pause and survey the scene. It's not much -- four white walls, grey industrial carpet. Margaret has helpfully assembled Faraji's desk and chair, though how sturdily is an open question. She also took the time to put up some of Agent Faraji's office decor -- their degree in Nonstandard Investigative Techniques, an original pencil drawing of the Pitfall snake by semi-acclaimed Washington DC artist Darius 5200, and a photo of their softball team. At the very least the wall coverings help compensate for the lack of windows. There's a disconnected landline on the desk. The office door is to the north, and there's a white metal door to the west.

Faraji mutters, "Where's my computer?"

A phone is ringing inside their desk.

>x phone
It's not yet hooked up.

A phone is ringing inside Faraji's desk.

>x desk
The desk is a cheap DIY piece held together with hex screws. It has a single drawer which is closed.

A phone is ringing inside Faraji's desk.

>open it
Faraji tries to open the desk to answer the phone, but it seems to be locked. They sigh. "Margaret must have the key."

A phone is ringing inside their desk.

>e
Faraji can't go that way.

A phone is ringing inside their desk.

>n
Agent Faraji is in the hallway. Their office is to the south, Klimp's is to the west, and Moira's is to the north. The front office is east.

A phone is ringing to the south.

>n
(first opening Moira's door)
It seems to be locked.

A phone is ringing to the south.

>e
Agent Faraji is in the front office. It's really a small storefront done up to resemble an office. A store sales counter serves as a front desk, behind which are located shelves of office supplies and a row of drawers. There are also a couch and coffee table here creating a makeshift seating area. An old department store clothing rack serves as a coatrack. Photos on the walls picture the Bureau in better days. A stack of used and empty cardboard boxes sits in one corner.

The Bureau's latest temporary worker, Margaret is bustling around with unrestrained enthusiasm, unpacking boxes and assembling an approximation of a respectable front office, all as if the Bureau isn't going to be shut down before the year is out.

A phone is ringing not too far away.

Faraji can ask about the whereabouts of the desk key or ask about the status of the computer.

>ask about key
Faraji says, "Hey Margaret, do you know anything about my desk key?"

"Sure I do -- I put it in your desk." She furrows her brow. "What's the matter?"

A phone is ringing not too far away.

They can ask about the status of the computer or ask for the hex wrench.

>out
Faraji steps out of the office into the parking lot.

Agent Faraji is at the south end of the strip mall parking lot. From here one can see just how humble BOSH's state has become: the office, to the west, is between a pawn shop (to the southwest) and a run-down laundromat (to the northwest) and across from an automatic car wash. To the south is a swampy area separating the lot from the interstate. The parking lot continues north.

Their Hyundai is parked nearby.

They can drive to Marsh Street.

>in
Just like in the store this once was, the door chimes as Faraji walks in.

Agent Faraji is in the front office. It's really a small storefront done up to resemble an office. A store sales counter serves as a front desk, behind which are located shelves of office supplies and a row of drawers. There are also a couch and coffee table here creating a makeshift seating area. An old department store clothing rack serves as a coatrack. Photos on the walls picture the Bureau in better days. A stack of used and empty cardboard boxes sits in one corner.

The Bureau's latest temporary worker, Margaret is bustling around with unrestrained enthusiasm, unpacking boxes and assembling an approximation of a respectable front office, all as if the Bureau isn't going to be shut down before the year is out.

A phone is ringing not too far away.

Faraji can ask about the status of the computer or ask for the hex wrench.

>out
Faraji steps out of the office into the parking lot.

Agent Faraji is at the south end of the strip mall parking lot. From here one can see just how humble BOSH's state has become: the office, to the west, is between a pawn shop (to the southwest) and a run-down laundromat (to the northwest) and across from an automatic car wash. To the south is a swampy area separating the lot from the interstate. The parking lot continues north.

Their Hyundai is parked nearby.

They can drive to Marsh Street.

>n
Faraji trudges to the other end of the parking lot. It's much like where they left.

Agent Faraji is at the north end of the strip mall parking lot.. This end is no more auspicious than the other. A convenience store lies to the east. To the west is a military recruitment center. North of here the parking lot exits onto a busy road. There is a rusty sign by the road naming the shopping center: Park Place. South is BOSH headquarters, among other things.

>s
Faraji walks back to the south end of the parking lot.

Agent Faraji is at the south end of the strip mall parking lot. From here one can see just how humble BOSH's state has become: the office, to the west, is between a pawn shop (to the southwest) and a run-down laundromat (to the northwest) and across from an automatic car wash. To the south is a swampy area separating the lot from the interstate. The parking lot continues north.

Their Hyundai is parked nearby.

They can drive to Marsh Street.

>n
Faraji trudges to the other end of the parking lot. It's much like where they left.

Agent Faraji is at the north end of the strip mall parking lot.. This end is no more auspicious than the other. A convenience store lies to the east. To the west is a military recruitment center. North of here the parking lot exits onto a busy road. There is a rusty sign by the road naming the shopping center: Park Place. South is BOSH headquarters, among other things.

* * *

>e
Faraji is greeted by a blast of music as they enter the store.

Agent Faraji is in the Li'l Nectarine Convenience Store. Li'l Nectarine offers great service and low prices, or so they say. This one's cluttered aisles and sparse shelves could make one wonder if that's true. Behind the counter is the typical array of cigarettes and lottery tickets. Under the counter is a glass case containing various useful items.

The clerk, a scruffy man in his mid-twenties, is leaning against the counter, looking bored.

>w
Faraji exits the store into the relative quiet of the nearby traffic.

Agent Faraji is at the north end of the strip mall parking lot.. This end is no more auspicious than the other. A convenience store lies to the east. To the west is a military recruitment center. North of here the parking lot exits onto a busy road. There is a rusty sign by the road naming the shopping center: Park Place. South is BOSH headquarters, among other things.

>e
Faraji is greeted by a blast of music as they enter the store.

Agent Faraji is in the Li'l Nectarine Convenience Store. Li'l Nectarine offers great service and low prices, or so they say. This one's cluttered aisles and sparse shelves could make one wonder if that's true. Behind the counter is the typical array of cigarettes and lottery tickets. Under the counter is a glass case containing various useful items.

The clerk, a scruffy man in his mid-twenties, is leaning against the counter, looking bored.

* * *

>w
Faraji exits the store into the relative quiet of the nearby traffic.

Agent Faraji is at the north end of the strip mall parking lot.. This end is no more auspicious than the other. A convenience store lies to the east. To the west is a military recruitment center. North of here the parking lot exits onto a busy road. There is a rusty sign by the road naming the shopping center: Park Place. South is BOSH headquarters, among other things.

>s
Faraji walks back to the south end of the parking lot.

Agent Faraji is at the south end of the strip mall parking lot. From here one can see just how humble BOSH's state has become: the office, to the west, is between a pawn shop (to the southwest) and a run-down laundromat (to the northwest) and across from an automatic car wash. To the south is a swampy area separating the lot from the interstate. The parking lot continues north.

Their Hyundai is parked nearby.

They can drive to Marsh Street.

>w
Just like in the store this once was, the door chimes as Faraji walks in.

Agent Faraji is in the front office. It's really a small storefront done up to resemble an office. A store sales counter serves as a front desk, behind which are located shelves of office supplies and a row of drawers. There are also a couch and coffee table here creating a makeshift seating area. An old department store clothing rack serves as a coatrack. Photos on the walls picture the Bureau in better days. A stack of used and empty cardboard boxes sits in one corner.

The Bureau's latest temporary worker, Margaret is bustling around with unrestrained enthusiasm, unpacking boxes and assembling an approximation of a respectable front office, all as if the Bureau isn't going to be shut down before the year is out.

A phone is ringing not too far away.

Faraji can ask about the status of the computer or ask for the hex wrench.

>ask about computer
"Margaret", Faraji says, "what's up with my computer?"

"Oh, it got busted up during the move. I have the box behind my desk -- you can see it if you want. We'll have to get you a new one."

A phone is ringing not too far away.

They can ask for the hex wrench.

>ask wrench
Faraji says, "Do you happen to have the hex wrench from putting together my desk?"

"Well, I did, but I dropped it down a heating vent behind my desk."

A phone is ringing not too far away.

>look behind desk
There are a number of shelves of office supplies behind the desk. There is also a heating vent on the floor here.

Faraji finds a beat-up cardboard box and pulls it out.

A phone is ringing not too far away.

>x vent
A typical vent with a grill which one would hope would stop things like, say, a hex wrench from falling through. It's set in the floor behind the front desk. A hex wrench lies in the curve of the air duct. The vent is held closed by four screws.

In the heating vent is a hex wrench.

A phone is ringing not too far away.

Faraji can ask for a screwdriver.

>take wrench
Faraji's fingers won't fit through the openings in the vent. They"ll have to open it first.

A phone is ringing not too far away.

They can ask for a screwdriver.

>open vent
The vent is held closed by four screws.

A phone is ringing not too far away.

Faraji can ask for a screwdriver.

* * *

>3
Agent Faraji is at the south end of the strip mall parking lot. From here one can see just how humble BOSH's state has become: the office is to the west, between a pawn shop (to the southwest) and a run-down laundromat (to the northwest) and across from an automatic car wash. To the south is a swampy area separating the lot from the interstate. The parking lot continues north.

Their Hyundai is parked nearby.

>x laundromat
Faraji peers through the windows of the laundromat at the rows of aging machines. A sign on the door says "Closed for renovations". They turn away, unimpressed.

>x car
An old bright red Hyundai Accent, it's been Faraji's personal means of transportation for years. And since the Bureau lost its fleet, it's their work car too.

>drive to marsh
It's a long way from Swamp Park to the posh suburb where the unlucky Fryes made their home before their tragic end. At last Faraji exits the Beltway and makes their way to Marsh Street. They pull up to a huge Victorian house.

Agent Faraji is in the driveway. The house is an imposing powder blue three-story Victorian edifice, replete with the essential gingerbread gracing the exterior. High English laurel hedges hide the house from the street, and conversely. A slate walkway leads northeast to the front door.

Their Hyundai is parked nearby.

They can drive to Swamp Park.

>drive to swamp park
Agent Faraji is at the south end of the strip mall parking lot. From here one can see just how humble BOSH's state has become: the office, to the west, is between a pawn shop (to the southwest) and a run-down laundromat (to the northwest) and across from an automatic car wash. To the south is a swampy area separating the lot from the interstate. The parking lot continues north.

Their Hyundai is parked nearby.

They can drive to Marsh Street.

>w
Just like in the store this once was, the door chimes as Faraji walks in.

Agent Faraji is in the front office. It's really a small storefront done up to resemble an office. A store sales counter serves as a front desk, behind which are located shelves of office supplies and a row of drawers. There are also a couch and coffee table here creating a makeshift seating area. An old department store clothing rack serves as a coatrack. Photos on the walls picture the Bureau in better days. A stack of used and empty cardboard boxes sits in one corner.

The Bureau's latest temporary worker, Margaret is bustling around with unrestrained enthusiasm, unpacking boxes and assembling an approximation of a respectable front office, all as if the Bureau isn't going to be shut down before the year is out. She sees Faraji and practically squeals. "Larch! I'm sorry -- Agent Faraji! How are you? I hope you don't mind -- I took the liberty of putting your desk together. I just love hex wrenches, don't you? Also, your new phone is here. I put it in your desk. Good timing! Now I just need you to give me your old phone so I can deactivate it."

Faraji hands Margaret their old phone. Margaret taps a few keys on her computer and says "There! All settled. Hey, what are you doing for lunch? Let me know when you get hungry!"

A phone is ringing not too far away.

* * *

>look behind desk
There are a number of shelves of office supplies behind the desk. There is also a heating vent on the floor here.

Faraji finds a beat-up cardboard box and pulls it out.

A phone is ringing not too far away.

>x vent
A typical vent with a grill which one would hope would stop things like, say, a hex wrench from falling through. It's set in the floor behind the front desk. A hex wrench lies in the curve of the air duct. The vent is held closed by four screws.

A phone is ringing not too far away.

Faraji can ask for a screwdriver.

>take wrench
There's nothing like that nearby.

>open vent
The vent is held closed by four screws.

A phone is ringing not too far away.

Faraji can ask for a screwdriver.

* * *

>e
An automatic car wash isn't of much use when one is on foot.

>w
Just like in the store this once was, the door chimes as Faraji walks in.

Agent Faraji is in the front office. It's really a small storefront done up to resemble an office. A store sales counter serves as a front desk, behind which are located shelves of office supplies and a row of drawers. There are also a couch and coffee table here creating a makeshift seating area. An old department store clothing rack serves as a coatrack. Photos on the walls picture the Bureau in better days. A stack of used and empty cardboard boxes sits in one corner.

The Bureau's latest temporary worker, Margaret is bustling around with unrestrained enthusiasm, unpacking boxes and assembling an approximation of a respectable front office, all as if the Bureau isn't going to be shut down before the year is out. She sees Faraji and practically squeals. "Larch! I'm sorry -- Agent Faraji! How are you? I hope you don't mind -- I took the liberty of putting your desk together. I just love hex wrenches, don't you? Also, your new phone is here. I put it in your desk. Good timing! Now I just need you to give me your old phone so I can deactivate it."

Faraji hands Margaret their old phone. Margaret taps a few keys on her computer and says "There! All settled. Hey, what are you doing for lunch? Let me know when you get hungry!"

A phone is ringing not too far away.

>w
Faraji extricates themself from talking with Margaret.

Agent Faraji is in the hallway. Their office is to the south, Klimp's is to the west, and Moira's is to the north. The front office is east.

A phone is ringing to the south.

>open door
Which do you mean, Faraji's door, Moira's door or Klimp's door?

>faraji's
That's already open.

A phone is ringing to the south.

>open ezra's door
That's already open.

A phone is ringing to the south.

>showme
hallway - room
    Faraji's door - open door
    Faraji - nonbinary
        Bureau credit card - money card
    Moira's door - locked door
    Klimp's door - locked door

>s
Agent Faraji is in their office. They pause and survey the scene. It's not much -- four white walls, grey industrial carpet. Margaret has helpfully assembled Faraji's desk and chair, though how sturdily is an open question. She also took the time to put up some of Agent Faraji's office decor -- their degree in Nonstandard Investigative Techniques, an original pencil drawing of the Pitfall snake by semi-acclaimed Washington DC artist Darius 5200, and a photo of their softball team. At the very least the wall coverings help compensate for the lack of windows. There's a disconnected landline on the desk. The office door is to the north, and there's a white metal door to the west.

Faraji mutters, "Where's my computer?"

A phone is ringing inside their desk.

>l
Agent Faraji is in their office. It's basically four white walls and grey carpet. There's a cheap desk and chair, and a disconnected phone on the desk. In lieu of windows, there are a few things on the wall: their degree in Nonstandard Investigative Techniques, a pencil drawing of the Pitfall snake, and a photo of their softball team. The office door is to the north, and there's a white metal door to the west.

A phone is ringing inside their desk.

>x drawin
There's nothing like that nearby.

>x drawing
Pencil on canvas, it's a fuzzy drawing of the 8-bit snake in the classic video game Pitfall.

A phone is ringing inside Faraji's desk.

>open desk
Faraji tries to open the desk to answer the phone, but it seems to be locked. They sigh. "Margaret must have the key."

A phone is ringing inside their desk.

>open back door
It seems to be locked.

A phone is ringing inside Faraji's desk.

* * *

>gonear back basement
Agent Faraji is in the back basement. 

Also here is a door to nowhere.

>x door
There seems to be nothing special about it.

>e
(first opening the door to nowhere)
Faraji can't, since the door to nowhere leads nowhere.

* * *

>gonear laundromat
(the Laundromat-facade)
Agent Faraji is at the south end of the strip mall parking lot. From here one can see just how humble BOSH's state has become: the office, to the west, is between a pawn shop (to the southwest) and a run-down laundromat (to the northwest) and across from an automatic car wash. To the south is a swampy area separating the lot from the interstate. The parking lot continues north.

Their Hyundai is parked nearby.

They can drive to Marsh Street.

>gonear laundromat basement
Agent Faraji is in the laundromat basement.

>w
Faraji can't go that way.

>e
Faraji can't go that way.

>s
Agent Faraji is in the back basement. 

Also here is a door to nowhere.

>e
(first opening the door to nowhere)
Faraji can't, since the door to nowhere leads nowhere.

>n
Agent Faraji is in the laundromat basement.

>u
Agent Faraji is in the laundromat back room.

>e
Agent Faraji is in the laundromat. This is the laundromat.

>e
Faraji can't go that way.

>se
Agent Faraji is at the south end of the strip mall parking lot. From here one can see just how humble BOSH's state has become: the office, to the west, is between a pawn shop (to the southwest) and a run-down laundromat (to the northwest) and across from an automatic car wash. To the south is a swampy area separating the lot from the interstate. The parking lot continues north.

Their Hyundai is parked nearby.

They can drive to Marsh Street.

>nw
A sign on the laundromat door says "Closed for renovations".

>undo
south end of the strip mall parking lot
[Previous turn undone.]

>undo
laundromat
[Previous turn undone.]

>se
Agent Faraji is at the south end of the strip mall parking lot. From here one can see just how humble BOSH's state has become: the office, to the west, is between a pawn shop (to the southwest) and a run-down laundromat (to the northwest) and across from an automatic car wash. To the south is a swampy area separating the lot from the interstate. The parking lot continues north.

Their Hyundai is parked nearby.

They can drive to Marsh Street.

>sw
Faraji's not that desperate -- yet.

>gonear pawn owner
Agent Faraji is in the pawn shop. This is more the seedy, gloomy stereotype of a pawn shop than the glitzy santized version of TV reality shows. The blinds in the windows are closed to only allow the barest slant of sunlight in, leaving the sickly fluorescent lights to illuminate the room. There is the distinct smell of cigar smoke. The glass counter is filled with a large collection of possibly valuable items. Behind it is an impressive array of firearms.

Also here is the pawn shop owner.

>ne
Once again -- "Cha-ching!" -- as Faraji leaves the store.

Agent Faraji is at the south end of the strip mall parking lot. From here one can see just how humble BOSH's state has become: the office, to the west, is between a pawn shop (to the southwest) and a run-down laundromat (to the northwest) and across from an automatic car wash. To the south is a swampy area separating the lot from the interstate. The parking lot continues north.

Their Hyundai is parked nearby.

They can drive to Marsh Street.

>drive to marsh
Agent Faraji is in the driveway. The house is an imposing powder blue three-story Victorian edifice, replete with the essential gingerbread gracing the exterior. High English laurel hedges hide the house from the street, and conversely. A slate walkway leads northeast to the front door.

Their Hyundai is parked nearby.

They can drive to Swamp Park.

>in
Faraji can't go that way.

>open door
The front door is out of reach.

>ne
Faraji mounts the steps to the front porch.

Agent Faraji is on the front step. The front door to the east opens onto a small porch, up a couple of steps from the front walk. Oleanders grow outside the door, soon to be in bloom.  The door itself is painted white with stained glass windows and a shiny gold mail slot emblazoned "LETTERS" in large art nouveau lettering, Its appearance is marred by crime scene tape and damage where the door was jimmied. A large padlock holds the door closed.

From here you can go south or north around the house. The driveway is to the southwest.

>open door
It seems to be locked.

>x lock
A heavy steel combination lock.

>open it
It isn't something Faraji can open.

* * *

>i
Faraji is carrying:
  the Bureau credit card
  a green smartphone

>drop all
Bureau credit card: Dropped.
green smartphone: You decide against leaving the phone behind.

>i
Faraji is carrying:
  a green smartphone

>s
The swamp would just muck up Agent Faraji's clothes.

>w
Just like in the store this once was, the door chimes as Faraji walks in.

Agent Faraji is in the front office. It's really a small storefront done up to resemble an office. A store sales counter serves as a front desk, behind which are located shelves of office supplies and a row of drawers. There are also a couch and coffee table here creating a makeshift seating area. An old department store clothing rack serves as a coatrack. Photos on the walls picture the Bureau in better days. A stack of used and empty cardboard boxes sits in one corner.

The Bureau's latest temporary worker, Margaret is bustling around with unrestrained enthusiasm, unpacking boxes and assembling an approximation of a respectable front office, all as if the Bureau isn't going to be shut down before the year is out. She sees Faraji and practically squeals. "Larch! I'm sorry -- Agent Faraji! How are you? I hope you don't mind -- I took the liberty of putting your desk together. I just love hex wrenches, don't you? Also, your new phone is here. I put it in your desk. Good timing! Now I just need you to give me your old phone so I can deactivate it."

Faraji hands Margaret their old phone. Margaret taps a few keys on her computer and says "There! All settled. Hey, what are you doing for lunch? Let me know when you get hungry!"

A phone is ringing not too far away.

>drop all
There are none at all available!

>i
Faraji is carrying nothing.

A phone is ringing not too far away.

* * *

>n
Faraji trudges to the other end of the parking lot. It's much like where they left.

Agent Faraji is at the north end of the strip mall parking lot.. This end is no more auspicious than the other. A convenience store lies to the east. To the west is a military recruitment center. North of here the parking lot exits onto a busy road. There is a rusty sign by the road naming the shopping center: Park Place. South is BOSH headquarters, among other things.

* * *

>e
Faraji is greeted by a blast of music as they enter the store.

Agent Faraji is in the Li'l Nectarine Convenience Store. Li'l Nectarine offers great service and low prices, or so they say. This one's cluttered aisles and sparse shelves could make one wonder if that's true. Behind the counter is the typical array of cigarettes and lottery tickets. Under the counter is a glass case containing various useful items.

The clerk, a scruffy man in his mid-twenties, is leaning against the counter, looking bored.

>talk
What do you want to talk to?

>man
There's nothing like that nearby.

>talk to clerk
Faraji says hello to the store clerk.

>ask clerk about flashlight
The store clerk does not respond.

>ask clerk about clerk
The store clerk does not respond.

>x glass case
In the glass case are a flashlight, a laptop computer, some wireless earbuds and a black smart phone.

>buy computer
(with the Bureau credit card)
The store clerk runs the Bureau credit card, but it's declined. You might want to call the bank.

>call the bank
I'm not sure what you're trying to say. I might just not recognize the words you're using.

>call bank
I'm not sure what you're trying to say. I might just not recognize the words you're using.

>x phone
(the green smartphone)
It's a pretty nice phone, only a couple of years old, but Faraji doesn't have time to play with it. They need to get to the office.

>call
(the green smartphone on the green smartphone)
Faraji can't call the phone they're calling from!

>call klimp
(on the green smartphone)
The green smartphone is out of batteries.

>x clerk
There seems to be nothing special about him.

>ask him for screwdriver
That is not a topic of conversation at the moment.

>e
Faraji can't go that way.

>w
Faraji exits the store into the relative quiet of the nearby traffic.

Agent Faraji is at the north end of the strip mall parking lot.. This end is no more auspicious than the other. A convenience store lies to the east. To the west is a military recruitment center. North of here the parking lot exits onto a busy road. There is a rusty sign by the road naming the shopping center: Park Place. South is BOSH headquarters, among other things.

* * *

>s
Faraji walks back to the south end of the parking lot.

Agent Faraji is at the south end of the strip mall parking lot. From here one can see just how humble BOSH's state has become: the office, to the west, is between a pawn shop (to the southwest) and a run-down laundromat (to the northwest) and across from an automatic car wash. To the south is a swampy area separating the lot from the interstate. The parking lot continues north.

Their Hyundai is parked nearby.

They can drive to Marsh Street.

>w
Just like in the store this once was, the door chimes as Faraji walks in.

Agent Faraji is in the front office. It's really a small storefront done up to resemble an office. A store sales counter serves as a front desk, behind which are located shelves of office supplies and a row of drawers. There are also a couch and coffee table here creating a makeshift seating area. An old department store clothing rack serves as a coatrack. Photos on the walls picture the Bureau in better days. A stack of used and empty cardboard boxes sits in one corner.

The Bureau's latest temporary worker, Margaret is bustling around with unrestrained enthusiasm, unpacking boxes and assembling an approximation of a respectable front office, all as if the Bureau isn't going to be shut down before the year is out. She sees Faraji and practically squeals. "Larch! I'm sorry -- Agent Faraji! How are you? I hope you don't mind -- I took the liberty of putting your desk together. I just love hex wrenches, don't you? Also, your new phone is here. I put it in your desk. Good timing! Now I just need you to give me your old phone so I can deactivate it."

Faraji hands Margaret their old phone. Margaret taps a few keys on her computer and says "There! All settled. Hey, what are you doing for lunch? Let me know when you get hungry!"

A phone is ringing not too far away.

* * *

>n
Agent Faraji is in the hallway. Their office is to the south, Klimp's is to the west, and Moira's is to the north. The front office is east.

A phone is ringing to the south.

>e
Agent Faraji is in the front office. It's really a small storefront done up to resemble an office. A store sales counter serves as a front desk, behind which are located shelves of office supplies and a row of drawers. There are also a couch and coffee table here creating a makeshift seating area. An old department store clothing rack serves as a coatrack. Photos on the walls picture the Bureau in better days. A stack of used and empty cardboard boxes sits in one corner.

The Bureau's latest temporary worker, Margaret is bustling around with unrestrained enthusiasm, unpacking boxes and assembling an approximation of a respectable front office, all as if the Bureau isn't going to be shut down before the year is out.

A phone is ringing not too far away.

Faraji can ask about the status of the computer.

>w
Agent Faraji is in the hallway. Their office is to the south, Klimp's is to the west, and Moira's is to the north. The front office is east.

A phone is ringing to the south.

>s
Agent Faraji is in their office. It's basically four white walls and grey carpet. There's a cheap desk and chair, and a disconnected phone on the desk. In lieu of windows, there are a few things on the wall: their degree in Nonstandard Investigative Techniques, a pencil drawing of the Pitfall snake, and a photo of their softball team. The office door is to the north, and there's a white metal door to the west.

A phone is ringing inside their desk.

* * *

>versions
That's not a verb I recognise.

>version
The Bureau of Strange Happenings
An Interactive Phenomenon by Phil Riley
Release 1 / Serial number 230430 / Inform 7 build 6M62 (I6/v6.34 lib 6/12N) SD
Identification number: //F61EFB05-03A9-4894-B076-9E767F9163A8//
Interpreter version 0.5.2 / VM 3.1.2 / Library serial number 080126
Standard Rules version 3/120430 by Graham Nelson
Epistemology version 9 by Eric Eve
Conversation Framework version 12 by Eric Eve
Conversation Responses version 7 by Eric Eve
Conversational Defaults version 3 by Eric Eve
Formatting Capture version 2/221014 by Daniel Stelzer (based on Text Capture by Eric Eve)
Essentials by Philip Riley
Facts by Philip Riley
Phones by Philip Riley
Commerce by Philip Riley
Furniture by Philip Riley
Third Person Narration by Philip Riley
Door Utils by Philip Riley
Early Declarations by Philip Riley
Farseeing by Philip Riley
Basics by Philip Riley
Memories by Philip Riley
Hyperspace by Philip Riley
BOSH Facts by Philip Riley
Image Strip by Philip Riley
Simple Conversation by Philip Riley
Swamp Park by Philip Riley
Conversations General by Philip Riley
Margaret by Philip Riley
Gender Options version 3/210331 by Nathanael Nerode
Hearing by Philip Riley
Far Away version 5/160517 by Jon Ingold
Real People by Philip Riley

* * *

>w
Just like in the store this once was, the door chimes as Faraji walks in.

Agent Faraji is in the front office. It's really a small storefront done up to resemble an office. A store sales counter serves as a front desk, behind which are located shelves of office supplies and a row of drawers. There are also a couch and coffee table here creating a makeshift seating area. An old department store clothing rack serves as a coatrack. Photos on the walls picture the Bureau in better days. A stack of used and empty cardboard boxes sits in one corner.

The Bureau's latest office manager, Margaret Chao is bustling around with unrestrained enthusiasm, unpacking boxes and assembling an approximation of a respectable front office, all as if the Bureau isn't going to be shut down before the year is out. It sees Faraji and practically squeals. "Agent Faraji! I'm sorry -- Larch! How are you? I hope you don't mind -- I took the liberty of putting your desk together. I just love hex wrenches, don't you? Also, your new phone is here. I put it in your desk. Good timing! Now I just need you to give me your old phone so I can deactivate it."

Faraji hands Margaret their old phone. Margaret taps a few keys on her computer and says "There! All settled. Hey, what are you doing for lunch? Let me know when you get hungry!"

A phone is ringing not too far away.

>ask about margaret
There's nothing like that nearby.

>how are you
Faraji says "How are you, Margaret?"

Margaret replies, "I'm great! Thanks!"

A phone is ringing not too far away.

* * *

>ask margaret how are you
I'm not sure what you're trying to say. I might just not recognize the words you're using.

>how are you
Faraji says "How are you, Margaret?"

Margaret replies, "I'm great! Thanks!"

A phone is ringing not too far away.

>ask margaret about herself
Margaret does not respond.

A phone is ringing not too far away.

>ask margaret about asdfasdf
Margaret does not respond.

A phone is ringing not too far away.

>ask margaret about margaret
Margaret does not respond.

A phone is ringing not too far away.

* * *

>n
Agent Faraji is in the hallway. Their office is to the south, Klimp's is to the west, and Moira's is to the north. The front office is east.

A phone is ringing to the south.

>e
Agent Faraji is in the front office. It's really a small storefront done up to resemble an office. A store sales counter serves as a front desk, behind which are located shelves of office supplies and a row of drawers. There are also a couch and coffee table here creating a makeshift seating area. An old department store clothing rack serves as a coatrack. Photos on the walls picture the Bureau in better days. A stack of used and empty cardboard boxes sits in one corner.

The Bureau's latest office manager, Margaret is bustling around with unrestrained enthusiasm, unpacking boxes and assembling an approximation of a respectable front office, all as if the Bureau isn't going to be shut down before the year is out.

A phone is ringing not too far away.

Faraji can ask about the status of the computer.

>w
Agent Faraji is in the hallway. Their office is to the south, Klimp's is to the west, and Moira's is to the north. The front office is east.

A phone is ringing to the south.

* * *

>drop all
(the Bureau credit card)
Dropped.

A phone is ringing not too far away.

>i
Faraji is carrying nothing.

A phone is ringing not too far away.

>foo
Agent Faraji is in the front office. It's really a small storefront done up to resemble an office. A store sales counter serves as a front desk, behind which are located shelves of office supplies and a row of drawers. There are also a couch and coffee table here creating a makeshift seating area. An old department store clothing rack serves as a coatrack. Photos on the walls picture the Bureau in better days. A stack of used and empty cardboard boxes sits in one corner.

The Bureau's latest temporary worker, Margaret is bustling around with unrestrained enthusiasm, unpacking boxes and assembling an approximation of a respectable front office, all as if the Bureau isn't going to be shut down before the year is out.

Also here is the Bureau credit card.

Faraji is carrying nothing.

A phone is ringing not too far away.

>w
Faraji extricates themself from talking with Margaret.

Agent Faraji is in the hallway. Their office is to the south, Klimp's is to the west, and Moira's is to the north. The front office is east.

A phone is ringing to the south.

>i
Faraji is carrying nothing.

A phone is ringing to the south.

>foo
Agent Faraji is in the hallway. Their office is to the south, Klimp's is to the west, and Moira's is to the north. The front office is east.

They are carrying nothing.

A phone is ringing to the south.

>restart
Are you sure you want to restart?

>y
Department of Homeland Security, Washington, DC
Open on a drab office with decor dating to the mid-eighties. The DHS assistant to the associate sub-director looks longingly at the office clock nearing five, then leans across the desk and impatiently states his demands:

"First name, last name, gender?"

(1) Ezra Gaunt (male), a skeptical, quick-witted, yet secretly nervous and insecure man and winner of the 2006 Baltimore County Edgar Allan Poe Trivia Competition;

(2) Petula Clark Goldberg (female), a skeptical, quick-witted, yet secretly nervous and insecure woman and former dog trainer;

or (3) Larch Faraji (non-conforming), a skeptical, quick-witted, yet secretly nervous and insecure person whose apartment has a whole bedroom for snake cages.

The Bureau of Strange Happenings
An Interactive Phenomenon by Phil Riley
Release 1 / Serial number 230210 / Inform 7 build 6M62 (I6/v6.34 lib 6/12N) SD

Agent Faraji is at the south end of the strip mall parking lot. From here one can see just how humble BOSH's state has become: the office, to the west, is between a pawn shop (to the southwest) and a run-down laundromat (to the northwest) and across from an automatic car wash. To the south is a swampy area separating the lot from the interstate. The parking lot continues north.

Their Hyundai is parked nearby.

They can drive to Marsh Street.

>w
Just like in the store this once was, the door chimes as Faraji walks in.

Agent Faraji is in the front office. It's really a small storefront done up to resemble an office. A store sales counter serves as a front desk, behind which are located shelves of office supplies and a row of drawers. There are also a couch and coffee table here creating a makeshift seating area. An old department store clothing rack serves as a coatrack. Photos on the walls picture the Bureau in better days. A stack of used and empty cardboard boxes sits in one corner.

The Bureau's latest temporary worker, Margaret is bustling around with unrestrained enthusiasm, unpacking boxes and assembling an approximation of a respectable front office, all as if the Bureau isn't going to be shut down before the year is out. She sees Faraji and practically squeals. "Larch! I'm sorry -- Agent Faraji! How are you? I hope you don't mind -- I took the liberty of putting your desk together. I just love hex wrenches, don't you? Also, your new phone is here. I put it in your desk. Good timing! Now I just need you to give me your old phone so I can deactivate it."

Faraji hands Margaret their old phone. Margaret taps a few keys on her computer and says "There! All settled. Hey, what are you doing for lunch? Let me know when you get hungry!"

A phone is ringing not too far away.

* * *

>w
Faraji extricates themself from talking with Margaret.

Agent Faraji is in the hallway. Their office is to the south, Klimp's is to the west, and Moira's is to the north. The front office is east.

A phone is ringing to the south.

>drop all
(the Bureau credit card)
Dropped.

A phone is ringing to the south.

>foo
Agent Faraji is in the hallway. Their office is to the south, Klimp's is to the west, and Moira's is to the north. The front office is east.

Also here is the Bureau credit card.

They are carrying nothing.

A phone is ringing to the south.

>restart
Are you sure you want to restart?

* * *

>take boxes
Faraji picks up a couple of boxes and flattens them.

Margaret says, "Hey, what are you doing with those boxes, Agent Faraji? You don't have to worry about that -- I'll get them." She takes the flattened boxes from Faraji and hustles off.

A phone is ringing not too far away.

Margaret goes west.

>w
Agent Faraji is in the hallway. Their office is to the south, Klimp's is to the west, and Moira's is to the north. The front office is east.

Also here is Margaret.

A phone is ringing to the south.

Margaret goes south.

>s
Agent Faraji is in their office. They pause and survey the scene. It's not much -- four white walls, grey industrial carpet. Margaret has helpfully assembled Faraji's desk and chair, though how sturdily is an open question. She also took the time to put up some of Agent Faraji's office decor -- their degree in Nonstandard Investigative Techniques, an original pencil drawing of the Pitfall snake by semi-acclaimed Washington DC artist Darius 5200, and a photo of their softball team. At the very least the wall coverings help compensate for the lack of windows. There's a disconnected landline on the desk. The office door is to the north, and there's a white metal door to the west.

Faraji mutters, "Where's my computer?"

A phone is ringing inside their desk.

Margaret unlocks the back door.

>w
(first opening the back door)
Agent Faraji is in the back lot. This is a small area of asphalt between building and a chain link fence looking in on an industrial property. There is a blue dumpster here.

A phone is ringing to the east.

Margaret arrives from the east.

>x dumpster
An everyday blue dumpster, about seven feet high.

A phone is ringing to the east.

Margaret tosses the flattened boxes over the edge of the dumpster.

>z
Faraji stands around and waits.

A phone is ringing to the east.

Margaret goes east.

>z
Faraji stands around and waits.

A phone is ringing to the east.

The back door closes.

>knock on door
The back door opens.

You hear the door being unlocked, and then Margaret pops her out. "Seriously, Agent Faraji? You got yourself locked out? Be more careful!"

A phone is ringing to the east.

>z
Faraji stands around and waits.

A phone is ringing to the east.

>z
Faraji stands around and waits.

A phone is ringing to the east.

>e
Agent Faraji is in their office. It's basically four white walls and grey carpet. There's a cheap desk and chair, and a disconnected phone on the desk. In lieu of windows, there are a few things on the wall: their degree in Nonstandard Investigative Techniques, a pencil drawing of the Pitfall snake, and a photo of their softball team. The office door is to the north, and there's a white metal door to the west.

Also here is Margaret.

A phone is ringing inside Faraji's desk.

>z
Faraji stands around and waits.

A phone is ringing inside their desk.

Margaret closes the back door.

Margaret locks the back door.

>hello
(addressing Margaret)
Faraji says hello to Margaret.

A phone is ringing inside Faraji's desk.

Margaret goes north.

>n
Agent Faraji is in the hallway. Their office is to the south, Klimp's is to the west, and Moira's is to the north. The front office is east.

Also here is Margaret.

A phone is ringing to the south.

Margaret goes east.

>e
Agent Faraji is in the front office. It's really a small storefront done up to resemble an office. A store sales counter serves as a front desk, behind which are located shelves of office supplies and a row of drawers. There are also a couch and coffee table here creating a makeshift seating area. An old department store clothing rack serves as a coatrack. Photos on the walls picture the Bureau in better days. A stack of used and empty cardboard boxes sits in one corner.

The Bureau's latest temporary worker, Margaret is bustling around with unrestrained enthusiasm, unpacking boxes and assembling an approximation of a respectable front office, all as if the Bureau isn't going to be shut down before the year is out.

A phone is ringing not too far away.

Faraji can ask about the status of the computer.

* * *

>w
Faraji extricates themself from talking with Margaret.

Agent Faraji is in the hallway. Their office is to the south, Klimp's is to the west, and Moira's is to the north. The front office is east.

A phone is ringing to the south.

* * *

>ask about computer
"Margaret", Faraji says, "what's up with my computer?"

"Oh, it got busted up during the move. I have the box behind my desk -- you can see it if you want. We'll have to get you a new one."

A phone is ringing not too far away.

* * *

>take boxes
Faraji picks up a couple of boxes and flattens them.

Margaret says, "Hey, what are you doing with those boxes, Agent Faraji? You don't have to worry about that -- I'll get them." She takes the flattened boxes from Faraji and hustles off.

A phone is ringing not too far away.

Margaret goes west.

* * *

>w
Agent Faraji is in the hallway. Their office is to the south, Klimp's is to the west, and Moira's is to the north. The front office is east.

Also here is Margaret.

A phone is ringing to the south.

Margaret goes south.

>s
Agent Faraji is in their office. It's basically four white walls and grey carpet. There's a cheap desk and chair, and a disconnected phone on the desk. In lieu of windows, there are a few things on the wall: their degree in Nonstandard Investigative Techniques, a pencil drawing of the Pitfall snake, and a photo of their softball team. The office door is to the north, and there's a white metal door to the west.

Also here is Margaret.

A phone is ringing inside Faraji's desk.

Margaret unlocks the back door.

>w
(first opening the back door)
Agent Faraji is in the back lot. This is a small area of asphalt between building and a chain link fence looking in on an industrial property. There is a blue dumpster here.

A phone is ringing to the east.

Margaret arrives from the east.

>z
Faraji stands around and waits.

A phone is ringing to the east.

Margaret tosses the flattened boxes over the edge of the dumpster.

>z
Faraji stands around and waits.

A phone is ringing to the east.

Margaret goes east.

* * *

>knock on door
The back door opens.

You hear the door being unlocked, and then Margaret pops her out. "Seriously, Agent Faraji? You got yourself locked out? Be more careful!"

A phone is ringing to the east.

>e
Agent Faraji is in their office. It's basically four white walls and grey carpet. There's a cheap desk and chair, and a disconnected phone on the desk. In lieu of windows, there are a few things on the wall: their degree in Nonstandard Investigative Techniques, a pencil drawing of the Pitfall snake, and a photo of their softball team. The office door is to the north, and there's a white metal door to the west.

A phone is ringing inside their desk.

>n
Agent Faraji is in the hallway. Their office is to the south, Klimp's is to the west, and Moira's is to the north. The front office is east.

A phone is ringing to the south.

* * *

>e
Agent Faraji is in their office. It's basically four white walls and grey carpet. There's a cheap desk and chair, and a disconnected phone on the desk. In lieu of windows, there are a few things on the wall: their degree in Nonstandard Investigative Techniques, a pencil drawing of the Pitfall snake, and a photo of their softball team. The office door is to the north, and there's a white metal door to the west.

Also here is Margaret.

A phone is ringing inside Faraji's desk.

>n
Agent Faraji is in the hallway. Their office is to the south, Klimp's is to the west, and Moira's is to the north. The front office is east.

A phone is ringing to the south.

>e
Agent Faraji is in the front office. It's really a small storefront done up to resemble an office. A store sales counter serves as a front desk, behind which are located shelves of office supplies and a row of drawers. There are also a couch and coffee table here creating a makeshift seating area. An old department store clothing rack serves as a coatrack. Photos on the walls picture the Bureau in better days. A stack of used and empty cardboard boxes sits in one corner.

A phone is ringing not too far away.

>hello
(addressing Margaret)
Faraji says hello to Margaret.

A phone is ringing not too far away.

Faraji can ask about the status of the computer.

* * *

>e
Agent Faraji is in the front office. It's really a small storefront done up to resemble an office. A store sales counter serves as a front desk, behind which are located shelves of office supplies and a row of drawers. There are also a couch and coffee table here creating a makeshift seating area. An old department store clothing rack serves as a coatrack. Photos on the walls picture the Bureau in better days. A stack of used and empty cardboard boxes sits in one corner.

A phone is ringing not too far away.

>rules
Rules tracing now switched on. Type "rules off" to switch it off again, or "rules all" to include even rules which do not apply.

[Rule "clear LPR rule" applies.]
[Rule "reset skip sounds rule" applies.]

* * *

>rules off
[Rule "redirect to GEP line input rule" applies.]
[Rule "ordinary checking for content rule" applies.]
[Rule "After reading a command" applies.]
[Rule "declare everything initially unmentioned rule" applies.]
Rules tracing now switched off. Type "rules" to switch it on again.

>z
Faraji stands around and waits.

A phone is ringing not too far away.

* * *

>e
Agent Faraji is in the front office. It's really a small storefront done up to resemble an office. A store sales counter serves as a front desk, behind which are located shelves of office supplies and a row of drawers. There are also a couch and coffee table here creating a makeshift seating area. An old department store clothing rack serves as a coatrack. Photos on the walls picture the Bureau in better days. A stack of used and empty cardboard boxes sits in one corner.

A phone is ringing not too far away.

>z
Faraji stands around and waits.

A phone is ringing not too far away.

They can ask about the status of the computer.

>hello
(addressing Margaret)
Faraji says hello to Margaret.

A phone is ringing not too far away.

Faraji can ask about the status of the computer.

* * *

>z
Faraji stands around and waits.

A phone is ringing not too far away.

They can ask about the status of the computer.

>z
Faraji stands around and waits.

A phone is ringing not too far away.

* * *

>x 5200
Pencil on canvas, it's a fuzzy drawing of the 8-bit snake in the classic video game Pitfall.

A phone is ringing inside Faraji's desk.

>x softball
Faraji's third from left in the front row.

A phone is ringing inside their desk.

>x front row
There's nothing like that nearby.

>x snake
Pencil on canvas, it's a fuzzy drawing of the 8-bit snake in the classic video game Pitfall.

A phone is ringing inside Faraji's desk.

>x nitwit
There's nothing like that nearby.

>x degree
It's Faraji's Bachelor's degree in Nonstandard Investigative Techniques from Wichita Institute of Technology. Which officially makes them a NITWIT. They shake their head and sigh.

A phone is ringing inside their desk.

>n
Agent Faraji is in the hallway. Their office is to the south, Klimp's is to the west, and Moira's is to the north. The front office is east.

A phone is ringing to the south.

* * *

>ask about computer
"Margaret", Faraji says, "what's up with my computer?"

"Oh, it got busted up during the move. I have the box behind my desk -- you can see it if you want. We'll have to get you a new one."

A phone is ringing not too far away.

>look behind desk
There are a number of shelves of office supplies behind the desk. There is also a heating vent on the floor here.

Faraji finds a beat-up cardboard box and pulls it out.

A phone is ringing not too far away.

* * *

>x vent
A typical vent with a grill which one would hope would stop things like, say, a hex wrench from falling through. It's set in the floor behind the front desk. A hex wrench lies in the curve of the air duct. The vent is held closed by four screws.

In the heating vent is a hex wrench.

A phone is ringing not too far away.

Faraji can ask for a screwdriver.

>x wrench
There seems to be nothing special about it.

A phone is ringing not too far away.

Faraji can ask for a screwdriver.

>take it
Faraji's fingers won't fit through the openings in the vent. They"ll have to open it first.

A phone is ringing not too far away.

They can ask for a screwdriver.

>ask for a screwdriver
Faraji asks, "Margaret, where's the screwdriver?"

"Umm... I think it was in a box we had to leave behind." Margaret looks embarrassed. "What? I never thought we'd need it. This isn't a construction site after all. Maybe if Klimp had paid for the bigger UHaul..." She stares past Faraji awkwardly.

A phone is ringing not too far away.

They can ask for a screwdriver.

>ask for a screwdriver
Faraji asks, "Are you sure we don't have one?"

Margaret just looks at Faraji darkly.

A phone is ringing not too far away.

They can ask for a screwdriver.

>ask about phone
There's nothing like that nearby.

>e
Faraji steps out of the office into the parking lot.

Agent Faraji is at the south end of the strip mall parking lot. From here one can see just how humble BOSH's state has become: the office, to the west, is between a pawn shop (to the southwest) and a run-down laundromat (to the northwest) and across from an automatic car wash. To the south is a swampy area separating the lot from the interstate. The parking lot continues north.

Their Hyundai is parked nearby.

They can drive to Marsh Street.

>n
Faraji trudges to the other end of the parking lot. It's much like where they left.

Agent Faraji is at the north end of the strip mall parking lot.. This end is no more auspicious than the other. A convenience store lies to the east. To the west is a military recruitment center. North of here the parking lot exits onto a busy road. There is a rusty sign by the road naming the shopping center: Park Place. South is BOSH headquarters, among other things.

* * *

>e
Faraji is greeted by a blast of music as they enter the store.

Agent Faraji is in the Li'l Nectarine Convenience Store. Li'l Nectarine offers great service and low prices, or so they say. This one's cluttered aisles and sparse shelves could make one wonder if that's true. Behind the counter is the typical array of cigarettes and lottery tickets. Under the counter is a glass case containing various useful items.

The clerk, a scruffy man in his mid-twenties, is leaning against the counter, looking bored.

>ask about screwdriver
Faraji asks, "Would you happen to have a screwdriver I could borrow?"

The clerk looks at you skeptically. "Sorry, no. Try the pawn shop guy."

They can ask for a screwdriver.

>ask about screwdriver
Faraji asks, "Would you happen to have a screwdriver I could borrow?"

He looks annoyed. "And have you run off with it? No way. Like I said, try the pawn shop!"

They can ask for a screwdriver.

>w
Faraji exits the store into the relative quiet of the nearby traffic.

Agent Faraji is at the north end of the strip mall parking lot.. This end is no more auspicious than the other. A convenience store lies to the east. To the west is a military recruitment center. North of here the parking lot exits onto a busy road. There is a rusty sign by the road naming the shopping center: Park Place. South is BOSH headquarters, among other things.

* * *

>s
Faraji walks back to the south end of the parking lot.

Agent Faraji is at the south end of the strip mall parking lot. From here one can see just how humble BOSH's state has become: the office, to the west, is between a pawn shop (to the southwest) and a run-down laundromat (to the northwest) and across from an automatic car wash. To the south is a swampy area separating the lot from the interstate. The parking lot continues north.

Their Hyundai is parked nearby.

They can drive to Marsh Street.

>sw
"Cha-ching!" rings the electronic chime as Faraji steps into the store.

Agent Faraji is in the pawn shop. This is more the seedy, gloomy stereotype of a pawn shop than the glitzy santized version of TV reality shows. The blinds in the windows are closed to only allow the barest slant of sunlight in, leaving the sickly fluorescent lights to illuminate the room. There is the distinct smell of cigar smoke. The glass counter is filled with a large collection of possibly valuable items. Behind it is an impressive array of firearms.

Also here is the pawn shop owner.

>tlk
That's not a verb I recognise.

>talk
(to the Bureau credit card)
The Bureau credit card does not respond.

>talk to the owner
The pawn shop owner grunts hello.

Faraji can ask for a screwdriver.

>ask for screwdriver
Faraji leans on the counter. "Hey, do you have a screwdriver? Can't find mine and I really need one."

The man shakes his head and says, "Sorry, miss. I had one, but the guy who runs the laundromat borrowed it and didn't bring it back."

Faraji can ask about the laundromat owner.

>ask about laundromat
Faraji nods. "Okay, then, how do I get in touch with this laundromat guy?"

"Well, that's a tricky one. Laundromat's been closed for almost two weeks now, since the owner just split for some reason he didn't bother to share. Not likely to get ahold of him. If you're not averse to a little trespassing, though, see if you come across a watch. Another thing he borrowed."

>out
Once again -- "Cha-ching!" -- as Faraji leaves the store.

Agent Faraji is at the south end of the strip mall parking lot. From here one can see just how humble BOSH's state has become: the office, to the west, is between a pawn shop (to the southwest) and a run-down laundromat (to the northwest) and across from an automatic car wash. To the south is a swampy area separating the lot from the interstate. The parking lot continues north.

Their Hyundai is parked nearby.

They can drive to Marsh Street.

>w
Just like in the store this once was, the door chimes as Faraji walks in.

Agent Faraji is in the front office. It's really a small storefront done up to resemble an office. A store sales counter serves as a front desk, behind which are located shelves of office supplies and a row of drawers. There are also a couch and coffee table here creating a makeshift seating area. An old department store clothing rack serves as a coatrack. Photos on the walls picture the Bureau in better days. A stack of used and empty cardboard boxes sits in one corner.

The Bureau's latest temporary worker, Margaret is bustling around with unrestrained enthusiasm, unpacking boxes and assembling an approximation of a respectable front office, all as if the Bureau isn't going to be shut down before the year is out.

Also here is a beat-up cardboard box (closed).

A phone is ringing not too far away.

Faraji can ask for a screwdriver.

>open box
Faraji opens the beat-up cardboard box, revealing their computer.

A phone is ringing not too far away.

They can ask for a screwdriver.

>x computer
Faraji's computer has been damaged beyond repair. But they do find a thumb drive and take it.

A phone is ringing not too far away.

They can remember finding the drive before.

They can ask for a screwdriver.

>remember finding the driver
I only understood you as far as wanting to remember finding the drive before.

>remember finding the drive
what is the story of the thumb drive?

A phone is ringing not too far away.

Faraji can ask for a screwdriver.

>l
Agent Faraji is in the front office. It's really a small storefront done up to resemble an office. A store sales counter serves as a front desk, behind which are located shelves of office supplies and a row of drawers. There are also a couch and coffee table here creating a makeshift seating area. An old department store clothing rack serves as a coatrack. Photos on the walls picture the Bureau in better days. A stack of used and empty cardboard boxes sits in one corner.

The Bureau's latest temporary worker, Margaret is bustling around with unrestrained enthusiasm, unpacking boxes and assembling an approximation of a respectable front office, all as if the Bureau isn't going to be shut down before the year is out.

Also here is a beat-up cardboard box (in which is Faraji's computer).

A phone is ringing not too far away.

They can ask for a screwdriver.

>x boxes
There is a stack of boxes in the corner.

A phone is ringing not too far away.

Faraji can ask for a screwdriver.

>take boxes
Faraji picks up a couple of boxes and flattens them.

Margaret says, "Hey, what are you doing with those boxes, Agent Faraji? You don't have to worry about that -- I'll get them." She takes the flattened boxes from Faraji and hustles off.

A phone is ringing not too far away.

Margaret goes west.

* * *

>w
Agent Faraji is in the hallway. Their office is to the south, Klimp's is to the west, and Moira's is to the north. The front office is east.

Also here is Margaret.

A phone is ringing to the south.

Margaret goes south.

>d
Faraji can't go that way.

A phone is ringing to the south.

>s
Agent Faraji is in their office. It's basically four white walls and grey carpet. There's a cheap desk and chair, and a disconnected phone on the desk. In lieu of windows, there are a few things on the wall: their degree in Nonstandard Investigative Techniques, a pencil drawing of the Pitfall snake, and a photo of their softball team. The office door is to the north, and there's a white metal door to the west.

Also here is Margaret.

A phone is ringing inside Faraji's desk.

Margaret goes west.

>w
Agent Faraji is in the back lot. This is a small area of asphalt between building and a chain link fence looking in on an industrial property. There is a blue dumpster here.

Also here is Margaret.

A phone is ringing to the east.

Margaret tosses the flattened boxes over the edge of the dumpster.

>x dumpster
An everyday blue dumpster, about seven feet high.

A phone is ringing to the east.

Margaret goes east.

>x industrial property
There's nothing like that nearby.

>climb into dumpster
There's nothing like that nearby.

>enter dumpster
That's not something Faraji can enter.

A phone is ringing to the east.

The white metal door closes.

>open door
It seems to be locked.

>undo
back lot
[Previous turn undone.]

>open door
It seems to be locked.

>l
Agent Faraji is in the back lot. This is a small area of asphalt between building and a chain link fence looking in on an industrial property. There is a blue dumpster here.

>x doo
There's nothing like that nearby.

>x door
An unremarkable metal door painted white. It is closed and locked.

>x window
There's nothing like that nearby.

>knock on door
The white metal door opens.

You hear the door being unlocked, and then Margaret pops her head out. "Seriously, Agent Faraji? You got yourself locked out? Be more careful!"

A phone is ringing to the east.

>e
Agent Faraji is in their office. It's basically four white walls and grey carpet. There's a cheap desk and chair, and a disconnected phone on the desk. In lieu of windows, there are a few things on the wall: their degree in Nonstandard Investigative Techniques, a pencil drawing of the Pitfall snake, and a photo of their softball team. The office door is to the north, and there's a white metal door to the west.

Also here is Margaret.

A phone is ringing inside Faraji's desk.

>z
Faraji stands around and waits.

A phone is ringing inside their desk.

Margaret closes the white metal door.

Margaret locks the white metal door.

>z
Faraji stands around and waits.

A phone is ringing inside their desk.

Margaret goes north.

>n
Agent Faraji is in the hallway. Their office is to the south, Klimp's is to the west, and Moira's is to the north. The front office is east.

Also here is Margaret.

A phone is ringing to the south.

Margaret goes east.

>e
Agent Faraji is in the front office. It's really a small storefront done up to resemble an office. A store sales counter serves as a front desk, behind which are located shelves of office supplies and a row of drawers. There are also a couch and coffee table here creating a makeshift seating area. An old department store clothing rack serves as a coatrack. Photos on the walls picture the Bureau in better days. A stack of used and empty cardboard boxes sits in one corner.

The Bureau's latest temporary worker, Margaret is bustling around with unrestrained enthusiasm, unpacking boxes and assembling an approximation of a respectable front office, all as if the Bureau isn't going to be shut down before the year is out.

Also here is a beat-up cardboard box (in which is Faraji's computer).

A phone is ringing not too far away.

They can ask for a screwdriver or ask to unlock the backdoor.

>unlock the backdoor
I didn't understand that sentence.

>ask to unlock the backdoor
Faraji asks, "Could you unlock the back door, Margaret?"

"Sorry, too busy right now. What do you want back there anyway? There's only a dumpster."

A phone is ringing not too far away.

They can ask for a screwdriver.

>take boxes
Faraji picks up a couple of boxes and flattens them.

Margaret says, "Hey, what are you doing with those boxes, Agent Faraji? You don't have to worry about that -- I'll get them." She takes the flattened boxes from Faraji and hustles off.

A phone is ringing not too far away.

Margaret goes west.

* * *

>w
Agent Faraji is in the hallway. Their office is to the south, Klimp's is to the west, and Moira's is to the north. The front office is east.

Also here is Margaret.

A phone is ringing to the south.

Margaret goes south.

>s
Agent Faraji is in their office. It's basically four white walls and grey carpet. There's a cheap desk and chair, and a disconnected phone on the desk. In lieu of windows, there are a few things on the wall: their degree in Nonstandard Investigative Techniques, a pencil drawing of the Pitfall snake, and a photo of their softball team. The office door is to the north, and there's a white metal door to the west.

Also here is Margaret.

A phone is ringing inside Faraji's desk.

Margaret unlocks the white metal door.

>restart
Are you sure you want to restart?

>y
Department of Homeland Security, Washington, DC
Open on a drab office with decor dating to the mid-eighties. The DHS assistant to the associate sub-director looks longingly at the office clock nearing five, then leans across the desk and impatiently states his demands:

"First name, last name, gender?"

(1) Ezra Gaunt (male), a skeptical, quick-witted, yet secretly nervous and insecure man and winner of the 2006 Baltimore County Edgar Allan Poe Trivia Competition;

(2) Petula Clark Goldberg (female), a skeptical, quick-witted, yet secretly nervous and insecure woman and former dog trainer;

or (3) Larch Faraji (non-conforming), a skeptical, quick-witted, yet secretly nervous and insecure person whose apartment has a whole bedroom for snake cages.

The Bureau of Strange Happenings
An Interactive Phenomenon by Phil Riley
Release 1 / Serial number 230411 / Inform 7 build 6M62 (I6/v6.34 lib 6/12N) SD

Agent Faraji is at the south end of the strip mall parking lot. From here one can see just how humble BOSH's state has become: the office, to the west, is between a pawn shop (to the southwest) and a run-down laundromat (to the northwest) and across from an automatic car wash. To the south is a swampy area separating the lot from the interstate. The parking lot continues north.

Their Hyundai is parked nearby.

They can drive to Marsh Street.

>w
Just like in the store this once was, the door chimes as Faraji walks in.

Agent Faraji is in the front office. It's really a small storefront done up to resemble an office. A store sales counter serves as a front desk, behind which are located shelves of office supplies and a row of drawers. There are also a couch and coffee table here creating a makeshift seating area. An old department store clothing rack serves as a coatrack. Photos on the walls picture the Bureau in better days. A stack of used and empty cardboard boxes sits in one corner.

The Bureau's latest temporary worker, Margaret is bustling around with unrestrained enthusiasm, unpacking boxes and assembling an approximation of a respectable front office, all as if the Bureau isn't going to be shut down before the year is out. She sees Faraji and practically squeals. "Larch! I'm sorry -- Agent Faraji! How are you? I hope you don't mind -- I took the liberty of putting your desk together. I just love hex wrenches, don't you? Also, your new phone is here. I put it in your desk. Good timing! Now I just need you to give me your old phone so I can deactivate it."

Faraji hands Margaret their old phone. Margaret taps a few keys on her computer and says "There! All settled. Hey, what are you doing for lunch? Let me know when you get hungry!"

A phone is ringing not too far away.

* * *

>x door
Which do you mean, Faraji's door or the white metal door?

>metal
An unremarkable metal door painted white. It is closed and locked.

A phone is ringing inside their desk.

>n
Agent Faraji is in the hallway. Their office is to the south, Klimp's is to the west, and Moira's is to the north. The front office is east.

A phone is ringing to the south.

* * *

>x ceiling
There's nothing like that nearby.

>take photos
There's nothing like that nearby.