Department of Homeland Security, Washington, DC
Open on a drab office with decor dating to the mid-eighties. The DHS assistant to the associate sub-director looks longingly at the office clock nearing five, then leans across the desk and impatiently states his demands:

"First name, last name, pronouns?"

(1) Ezra Gaunt (he/him), winner of the 2006 Baltimore County Edgar Allan Poe Trivia Competition;

(2) Petula Clark Goldberg (she/her), former award-winning dog groomer of the avant-garde school;

or (3) Larch Faraji (they/them), lead singer of the third wave neo-old-school punk band DC Trash.

The Bureau of Strange Happenings
An Interactive Phenomenon by Phil Riley
Release 1 / Serial number 240218 / Inform 7 build 6M62 (I6/v6.34 lib 6/12N) SD

Agent Faraji is at the south end of the strip mall parking lot. From here one can see just how humble BOSH's state has become: the office is to the west, between a pawn shop (to the southwest) and a run-down laundromat (to the northwest) and across from an automatic car wash. To the south is a swampy area separating the lot from the interstate. The parking lot continues north.

Their Hyundai is parked nearby.

>drive car
(Faraji's Hyundai)
Their job is here for now.

I beg your pardon?

>drive phone
You can't drive that.

* * *

>gonear main at solvay
Agent Faraji is on Main and Solvay. Main Street runs east from here, while Solvay Road heads north. South of here, Henry's Hot Skillet promises all of the comforts of the mid-twentieth-century diner. A book store named The Reading Room lies to the west, while Fresnel's Music is southwest.

>x henry's
Henry's is closed, the neon skillet dark and motionless.

>s
(first opening the Skillet door)
It seems to be locked.

>e
Agent Faraji is on 200 block of Main Street. The street runs east and west from here. South is the edifice of Rolle's Department Store. North is the town hall.

>e
Agent Faraji is on Main and Lake.

>n
Agent Faraji is walking on Lake Street by the gym.

>n
Agent Faraji is walking on Lake Street by the park.

>n
Agent Faraji is at the intersection of Lake Street and Ridge Road. The intersection lies at the edge of the lake. Lake Street runs south into town, while Ridge Road heads off into the darkness east of here. A little park along the lake shore is to the west.

There is an abandoned pickup truck at the side of the road.

The seeming sound of sibilant speech carries on the breeze.

>open truck
Faraji opens the abandoned pickup truck, revealing nothing.

>enter it
Agent Faraji is at the intersection of Lake Street and Ridge Road. They are in the abandoned pickup truck. There is a glove compartment on the passenger side, closed.

The intersection lies at the edge of the lake. Lake Street runs south into town, while Ridge Road heads off into the darkness east of here. A little park along the lake shore is to the west.

>open compartment
Faraji opens the glove compartment, revealing a brass key.

>take brass key
Taken.

>start truck
Your key doesn't fit the ignition.

>purloin white key
[Purloined.]

>start truck
None of the keys you have fits the ignition.

>get out
Faraji gets out of the abandoned pickup truck.

Agent Faraji is at the intersection of Lake Street and Ridge Road. The intersection lies at the edge of the lake. Lake Street runs south into town, while Ridge Road heads off into the darkness east of here. A little park along the lake shore is to the west.

There is an abandoned pickup truck at the side of the road.

>drop all keys
white key: Dropped.
brass key: Dropped.

>enter
Agent Faraji is at the intersection of Lake Street and Ridge Road. They are in the abandoned pickup truck. There is a glove compartment on the passenger side, open.

The intersection lies at the edge of the lake. Lake Street runs south into town, while Ridge Road heads off into the darkness east of here. A little park along the lake shore is to the west.

Also here are a brass key and a white key.

>start truck
Even if this thing runs, you don't have the key.

>out
Faraji gets out of the abandoned pickup truck.

Agent Faraji is at the intersection of Lake Street and Ridge Road. The intersection lies at the edge of the lake. Lake Street runs south into town, while Ridge Road heads off into the darkness east of here. A little park along the lake shore is to the west.

There is an abandoned pickup truck at the side of the road.

Also here are a brass key and a white key.

They turn their head quickly, as if something caught their eye.

>e
Faraji can't go that way.

>s
Agent Faraji is walking on Lake Street by the park.

>e
Agent Faraji is in First Unitarian Church of Enigma Lake.

>e
Agent Faraji is in the vestry.

>w
Agent Faraji is in First Unitarian Church of Enigma Lake.

>w
Agent Faraji is walking on Lake Street by the park.

>w
Agent Faraji is in Enigma Park. It's probably beautiful during the day, but tonight the deep shadows among the trees seem ominous. They are watchful and tense as they explore the park.

The central focus of the park is a large obelisk inscribed with the names of the town's citizens lost in the Great War. The town hall is to the south, and other exits are to the north, west, and east.

>e
Agent Faraji is walking on Lake Street by the park.

>x park
Agent Faraji is walking on Lake Street by the park.

>x lake
Agent Faraji is walking on Lake Street by the park.

>s
Agent Faraji is walking on Lake Street by the gym.

>x town
The archetypical town hall of the northeastern US, it's a white-sided building the size of a large house, exuding a sense of civic duty. There are no entrances on this side.

>s
Agent Faraji is on Main and Lake. 

A strange shadow crosses the scene.

>w
Agent Faraji is on 200 block of Main Street. The street runs east and west from here. South is the edifice of Rolle's Department Store. North is the town hall.

>n
Agent Faraji is in the Enigma Lake town hall. The building has been cleared of furniture and other items ahead of the imminent flooding. A permanent fixture, the information desk sits near the front entrance (to the south). Taped to it is what looks to be a work schedule. There is also a back entrance onto the park to the north.

>n
Faraji pushes through the back door into the cool night.

Agent Faraji is in Enigma Park. The central focus of the park is a large obelisk inscribed with the names of the town's citizens lost in the Great War. The town hall is to the south, and other exits are to the north, west, and east.

They abruptly spin around, but find nothing behind them.

>w
Agent Faraji is walking on Solvay Road leading out of town.

>n
Agent Faraji is at the west end of the town's lake shore.

>w
Faraji can't go that way.

>sw
Faraji can't go that way.

>s
Agent Faraji is walking on Solvay Road leading out of town.

>nw
Agent Faraji is walking on Solvay Road by the lake.

I beg your pardon?

>w
Agent Faraji is in a dirty shack. 

Also here are Hutz and a sledgehammer.

>e
Agent Faraji is walking on Solvay Road by the lake.

>e
Faraji can't go that way.

>s
Faraji can't go that way.

>se
Agent Faraji is walking on Solvay Road leading out of town.

>e
Agent Faraji is in Enigma Park. The central focus of the park is a large obelisk inscribed with the names of the town's citizens lost in the Great War. The town hall is to the south, and other exits are to the north, west, and east.

>n
Agent Faraji is on the lake shore north of the park.

>e
Agent Faraji is at the intersection of Lake Street and Ridge Road. The intersection lies at the edge of the lake. Lake Street runs south into town, while Ridge Road heads off into the darkness east of here. A little park along the lake shore is to the west.

There is an abandoned pickup truck at the side of the road.

Also here are a brass key and a white key.

>s
Agent Faraji is walking on Lake Street by the park.

* * *

>start truck
None of the keys you have fits the ignition.

>i
Faraji is carrying:
  a white key
  a brass key
  a green smartphone

>x keys
There seems to be nothing special about it.

The seeming sound of sibilant speech carries on the breeze.

>drop keys
Dropped.

>i
Faraji is carrying:
  a white key
  a green smartphone

>take all keys
Taken.

>i
Faraji is carrying:
  a brass key
  a white key
  a green smartphone

* * *

>s
(first opening the Skillet door)
It seems to be locked.

>purloin key
Which do you mean, the white key, about the whereabouts of the desk key, for the hex wrench, the old copper key, the locker key, the red key, the brass key, the little grey key or the hex wrench?

>white
[Purloined.]

>s
(first opening the Skillet door)
It seems to be locked.

>purloin grey key
Which do you mean, about the whereabouts of the desk key or the little grey key?

>little grey key
Which do you mean, about the whereabouts of the desk key or the little grey key?

>putloin brass key
There seems to be no such object anywhere in the model world.

>purloin brass key
[Purloined.]

>s
(first opening the Skillet door)
It seems to be locked.

>unlock skillet door
What do you want to unlock the Skillet door with?

>brass key
Faraji unlocks the Skillet door.

>s
(first opening the Skillet door)
Agent Faraji is in Henry's Hot Skillet.

* * *

>gonear main solvay
Agent Faraji is on the corner of Main and Solvay. Main Street runs east from here, while Solvay Road heads north. South of here, Henry's Hot Skillet promises all of the comforts of the mid-twentieth-century diner. A book store named The Reading Room lies to the west, while Fresnel's Music is southwest.

>s
(first opening the Skillet door)
It seems to be locked.

>w
Agent Faraji is in the Reading Room.

>w
Faraji can't go that way.

>e
Agent Faraji is on the corner of Main and Solvay. Main Street runs east from here, while Solvay Road heads north. South of here, Henry's Hot Skillet promises all of the comforts of the mid-twentieth-century diner. A book store named The Reading Room lies to the west, while Fresnel's Music is southwest.

>sw
Agent Faraji is in Fresnel's Music. 

Also here is a tuning fork.

>x fork
There seems to be nothing special about it.

>ne
Agent Faraji is on the corner of Main and Solvay. Main Street runs east from here, while Solvay Road heads north. South of here, Henry's Hot Skillet promises all of the comforts of the mid-twentieth-century diner. A book store named The Reading Room lies to the west, while Fresnel's Music is southwest.

>n
Agent Faraji is walking on Solvay Road by the fire station. Solvay heads north and south. To the west is the fire station, while to the east is the side of the town hall.

>n
Agent Faraji is walking on Solvay Road leading out of town. Solvay Road bends here, leading northwest out of town and south back into town. East is the park, and to the west is Horton House.

>x park
A shadowy clump of trees marks the edge of Enigma Park.

>e
Agent Faraji is in Enigma Park. It's probably beautiful during the day, but tonight the deep shadows among the trees seem ominous. They are watchful and tense as they explore the park.

The central focus of the park is a large obelisk inscribed with the names of the town's citizens lost in the Great War. The town hall is to the south, and other exits are to the north, west, and east.

>x park
Agent Faraji is in Enigma Park. The central focus of the park is a large obelisk inscribed with the names of the town's citizens lost in the Great War. The town hall is to the south, and other exits are to the north, west, and east.

>x obelisk
Its faux Egyptian design is incongruous adjacent to the adamantly traditional town hall. Faraji can just make out a small crystal adornment rising from the top.

>climb it
The obelisk offers no handholds adequate for climbing.

>take adornment
It's too high up.

>x it
There seems to be nothing special about it.

>move it
It's too high up.

* * *

>climb it
The obelisk offers no handholds adequate for climbing.

>x adornment
There's nothing like that nearby.

* * *

>gonear shack
Agent Faraji is in a dirty shack. 

A bony old man reclining on a bed in a corner of the shack cackles and says "Ah, there you are, there you are. Knew you'd be around eventually."

Also here is a sledgehammer.

>e
Agent Faraji is walking on Solvay Road by the lake.

>q
Are you sure you want to quit?

* * *

>w
Agent Faraji is in a dirty shack. 

Hutz is reclining on a narrow bed.

Also here is a sledgehammer.

Faraji can ask why he's still here.

>ask why hutz is still here
Faraji asks, "Why are you still here? The town is being flooded tomorrow.

"Had a feeling someone might come by looking for help. And here you are."

* * *

>e
Agent Faraji is walking on Solvay Road by the lake.

>w
Agent Faraji is in a dirty shack. 

The bony old man is reclining on a narrow bed.

Also here is a sledgehammer.

Faraji can ask who he is.

>ask who hutz is
There's nothing like that nearby.

>who are you
Faraji asks, "You seem to know me, but who are you?"

"Name's Hutz, the town groundskeeper."

Faraji can ask why he's still here.

>why are you here
Faraji asks, "Why are you still here? The town is being flooded tomorrow."

"Had a feeling someone might come by looking for help. And here you are."

* * *

>w
Agent Faraji is in a dirty shack. 

The bony old man is reclining on a narrow bed.

Also here is a sledgehammer.

Faraji can ask who he is.

>why are you still here
Faraji asks, "Why are you still here? The town is being flooded tomorrow."

"Had a feeling someone might come by looking for help. And here you are."

>x bed
Clean enough, but awfully narrow, it holds the bony figure of Hutz, the town groundsman.

>x hutz
Hutz is more or less a skeleton in overalls.

>x bed
Clean enough, but awfully narrow, it holds the bony figure of Hutz, the town groundsman.

* * *

>w
Agent Faraji is in a dirty shack. 

The bony old man is reclining on a narrow bed.

Also here is a sledgehammer.

Faraji can ask who he is.

>x hutz
The bony old man is more or less a skeleton in overalls.

Faraji can ask why he's still here.

* * *

>gonear shack
Agent Faraji is in a dirty shack. 

A bony old man reclining on a bed in a corner of the shack cackles and says "Ah, there you are, there you are. Knew you'd be around eventually."

Also here is a sledgehammer.

>l
Agent Faraji is in a dirty shack. 

The bony old man is reclining on a narrow bed.

Also here is a sledgehammer.

>e
Agent Faraji is walking on Solvay Road by the lake.

* * *

>l
Agent Faraji is in a dirty shack. 

The bony old man is reclining on a narrow bed.

Also here is a sledgehammer.

>x man
There's nothing like that nearby.

* * *

>gonear shack
Agent Faraji is in a dirty shack. 

A bony old man reclining on a bed in a corner of the shack cackles and says "Ah, there you are, there you are. Knew you'd be around eventually."

Also here is a sledgehammer.

>x hutz
There's nothing like that nearby.

>rules
Rules tracing now switched on. Type "rules off" to switch it off again, or "rules all" to include even rules which do not apply.

[Rule "clear LPR rule" applies.]
[Rule "reset skip sounds rule" applies.]

* * *

>showme hutz
[Rule "After reading a command" applies.]
(ADAPTIVE PERSONbony old man)
[Rule "declare everything initially unmentioned rule" applies.]
[Rule "clear questioning rule" applies.]
ADAPTIVE PERSONbony old man - man
location: in the dirty shack
singular-named, proper-named, unmarked for special listing; unlit, inedible, portable, male, seen, familiar, quiet, background; adaptively-named
list grouping key: none
printed name: "Hutz"
printed plural name: "men"
indefinite article: "the"
most recent reference: nominal
third singular pronoun: He-pronoun
summary: none
description: "Hutz is more or less a skeleton in overalls."
initial appearance: "Hutz is reclining on a narrow bed."
dark description: none
hearability: very loud
volume: 0.0
price: $0
behind description: none
third-plural-pronoun: They-pronoun
possessive: none
portrait: Figure Null
carrying capacity: 100
behavior stack: Doing nothing
target location: Room of Subjects
remembrances: 
queue: why he's still here
first-singular-pronoun: I-pronoun
first-plural-pronoun: We-pronoun
second-singular-pronoun: Singular-you-pronoun
second-plural-pronoun: Plural-you-pronoun
person condition: anonymous

[Rule "clear LPR rule" applies.]
[Rule "reset skip sounds rule" applies.]

>rules off
[Rule "After reading a command" applies.]
[Rule "declare everything initially unmentioned rule" applies.]
[Rule "clear questioning rule" applies.]
Rules tracing now switched off. Type "rules" to switch it on again.

>showme hutz
(ADAPTIVE PERSONbony old man)
ADAPTIVE PERSONbony old man - man
location: in the dirty shack
singular-named, proper-named, unmarked for special listing; unlit, inedible, portable, male, seen, familiar, quiet, background; adaptively-named
list grouping key: none
printed name: "Hutz"
printed plural name: "men"
indefinite article: "the"
most recent reference: nominal
third singular pronoun: He-pronoun
summary: none
description: "Hutz is more or less a skeleton in overalls."
initial appearance: "Hutz is reclining on a narrow bed."
dark description: none
hearability: very loud
volume: 0.0
price: $0
behind description: none
third-plural-pronoun: They-pronoun
possessive: none
portrait: Figure Null
carrying capacity: 100
behavior stack: Doing nothing
target location: Room of Subjects
remembrances: 
queue: why he's still here
first-singular-pronoun: I-pronoun
first-plural-pronoun: We-pronoun
second-singular-pronoun: Singular-you-pronoun
second-plural-pronoun: Plural-you-pronoun
person condition: anonymous

>showme
dirty shack - room
    Adjacent light - backdrop
    Hyperlight - backdrop
    ceiling - backdrop
    floor - backdrop
    wall - backdrop
    Faraji - nonbinary
        green smartphone - phone
    ADAPTIVE PERSONbony old man - man
    narrow bed
    sledgehammer

>l
Agent Faraji is in a dirty shack. 

Hutz is reclining on a narrow bed.

Also here is a sledgehammer.

* * *

>x hutz
There's nothing like that nearby.

>showme hutz
(the bony old man)
bony old man - man
location: in the dirty shack
singular-named, improper-named, unmarked for special listing; unlit, inedible, portable, male, seen, familiar, quiet, background; adaptively-named
list grouping key: none
printed name: "Hutz"
printed plural name: "men"
indefinite article: "the"
most recent reference: nominal
third singular pronoun: He-pronoun
summary: none
description: "The bony old man is more or less a skeleton in overalls."
initial appearance: "The bony old man is reclining on a narrow bed."
dark description: none
hearability: very loud
volume: 0.0
price: $0
behind description: none
third-plural-pronoun: They-pronoun
possessive: none
portrait: Figure Null
carrying capacity: 100
behavior stack: Doing nothing
target location: Room of Subjects
remembrances: 
queue: why he's still here
first-singular-pronoun: I-pronoun
first-plural-pronoun: We-pronoun
second-singular-pronoun: Singular-you-pronoun
second-plural-pronoun: Plural-you-pronoun
person condition: anonymous

>e
Agent Faraji is walking on Solvay Road by the lake.

>w
Agent Faraji is in a dirty shack. 

The bony old man is reclining on a narrow bed.

Also here is a sledgehammer.

Faraji can ask why he's still here.

>showme hutz
(the bony old man)
bony old man - man
location: in the dirty shack
singular-named, improper-named, unmarked for special listing; unlit, inedible, portable, male, seen, familiar, quiet, background; adaptively-named
list grouping key: none
printed name: "Hutz"
printed plural name: "men"
indefinite article: "the"
most recent reference: nominal
third singular pronoun: He-pronoun
summary: none
description: "The bony old man is more or less a skeleton in overalls."
initial appearance: "The bony old man is reclining on a narrow bed."
dark description: none
hearability: very loud
volume: 0.0
price: $0
behind description: none
third-plural-pronoun: They-pronoun
possessive: none
portrait: Figure Null
carrying capacity: 100
behavior stack: Doing nothing
target location: Room of Subjects
remembrances: 
queue: why he's still here
first-singular-pronoun: I-pronoun
first-plural-pronoun: We-pronoun
second-singular-pronoun: Singular-you-pronoun
second-plural-pronoun: Plural-you-pronoun
person condition: anonymous

>x hutz
The bony old man is more or less a skeleton in overalls.

Faraji can ask why he's still here.

* * *

>x hutz
There's nothing like that nearby.

>x town
There's nothing like that nearby.

>x groundskeeper
There's nothing like that nearby.

* * *

>gonear shack
Agent Faraji is in a dirty shack. 

A bony old man reclining on a bed in a corner of the shack cackles and says "Ah, there you are, there you are. Knew you'd be around eventually."

Also here is a sledgehammer.

>x man
The bony old man is more or less a skeleton in overalls.

>talk to man
Faraji can ask why he's still here.

>ask why hutz is still here
Faraji asks, "Why are you still here? The town is being flooded tomorrow."

"Had a feeling someone might come by looking for help. And here you are."

>x hutz
The bony old man is more or less a skeleton in overalls.

>show hutz
(the green smartphone)
That doesn't seem to be a topic of conversation at the moment.

>showme hutz
(the bony old man)
bony old man - man
location: in the dirty shack
singular-named, improper-named, unmarked for special listing; unlit, inedible, portable, male, seen, familiar, quiet, background; adaptively-named
list grouping key: none
printed name: "Hutz"
printed plural name: "men"
indefinite article: "the"
most recent reference: nominal
third singular pronoun: He-pronoun
summary: none
description: "The bony old man is more or less a skeleton in overalls."
initial appearance: "The bony old man is reclining on a narrow bed."
dark description: none
hearability: very loud
volume: 0.0
price: $0
behind description: none
third-plural-pronoun: They-pronoun
possessive: none
portrait: Figure Null
carrying capacity: 100
behavior stack: Doing nothing
target location: Room of Subjects
remembrances: 
queue: 
first-singular-pronoun: I-pronoun
first-plural-pronoun: We-pronoun
second-singular-pronoun: Singular-you-pronoun
second-plural-pronoun: Plural-you-pronoun
person condition: anonymous

* * *

>x man
The bony old man is more or less a skeleton in overalls.

>x hutz
The bony old man is more or less a skeleton in overalls.

* * *

>gonear shack
Agent Faraji is in a dirty shack. 

A bony old man reclining on a bed in a corner of the shack cackles and says "Ah, there you are, there you are. Knew you'd be around eventually."

Also here is a sledgehammer.

>z
Faraji stands around and waits.

>l
Agent Faraji is in a dirty shack. 

The bony old man is reclining on a narrow bed.

Also here is a sledgehammer.

* * *

>e
Agent Faraji is walking on Solvay Road by the lake.

>w
Agent Faraji is in a dirty shack. 

Hutz is reclining on a narrow bed.

Also here is a sledgehammer.

* * *

>l
Agent Faraji is in a dirty shack. 

The bony old man is reclining on a narrow bed.

Also here is a sledgehammer.

>x hutz
The bony old man is more or less a skeleton in overalls.

* * *

>gonear solvay by the lake
Agent Faraji is walking on Solvay Road by the lake.

>w
Agent Faraji is in a dirty shack. Someone lives here, though not at all luxuriously. Plates are stacked up by the sink, and the whole place stinks of cat.

An orange cat stretches out on the bed.

A bony old man lies on a bed in a corner of the shack. He stirs sleepily and says "Ah, there you are, there you are. Knew you'd be around eventually."

Also here is a sledgehammer.

Faraji can ask who he is.

>ask who he is
Faraji asks, "You seem to know me, but who are you?"

"Name's Hutz, the town groundskeeper."

Faraji can ask why he's still here.

>showme hutz
(Hutz)
Hutz - man
location: in the dirty shack
singular-named, proper-named, unmarked for special listing; unlit, inedible, portable, male, seen, familiar, quiet, background; adaptively-named
list grouping key: none
printed name: "Hutz"
printed plural name: "men"
indefinite article: "the"
most recent reference: nominal
third singular pronoun: He-pronoun
summary: none
description: "Hutz is more or less a skeleton in overalls."
initial appearance: "Hutz is reclining on a narrow bed."
dark description: none
hearability: very loud
volume: 0.0
price: $0
behind description: none
third-plural-pronoun: They-pronoun
possessive: none
portrait: Figure Hutz
carrying capacity: 100
behavior stack: Doing nothing
target location: Room of Subjects
remembrances: 
queue: why he's still here
first-singular-pronoun: I-pronoun
first-plural-pronoun: We-pronoun
second-singular-pronoun: Singular-you-pronoun
second-plural-pronoun: Plural-you-pronoun
person condition: met

>showme how-can-you-help-me
how he can help Faraji - quip
location: in the room of quips
singular-named, proper-named, unmarked for special listing; unlit, inedible, portable, neuter, unseen, unfamiliar, quiet, background; one-shot
list grouping key: none
printed name: "how he can help them"
printed plural name: "quips"
indefinite article: none
most recent reference: nominal
third singular pronoun: It-pronoun
summary: none
description: none
initial appearance: none
dark description: none
hearability: very loud
volume: 0.0
price: $0
behind description: none
third-plural-pronoun: They-pronoun
possessive: none
portrait: Figure Null
comment: ""But how can you possibly help me?" they ask."
reply: ""You're looking for the secret of Enigma Lake, are you not? The secret about to be lost forever? Something calls you here; you're searching for something, no, someone. Yes, yes, Hutz can help you.""
quip condition: questioning
quip condition 2: plausibility-normal

>rules
Rules tracing now switched on. Type "rules off" to switch it off again, or "rules all" to include even rules which do not apply.

[Rule "clear LPR rule" applies.]
[Rule "reset skip sounds rule" applies.]

* * *

>rules off
[Rule "After reading a command" applies.]
[Rule "declare everything initially unmentioned rule" applies.]
[Rule "clear questioning rule" applies.]
Rules tracing now switched off. Type "rules" to switch it on again.

>l
Agent Faraji is in a dirty shack. Someone lives here, though not at all luxuriously. Plates are stacked up by the sink, and the whole place stinks of cat.

A mangy orange cat peeks out from under the bed.

Hutz is reclining on a narrow bed.

Also here is a sledgehammer.

* * *

>ask who he is
Faraji asks, "You seem to know me, but who are you?"

"Name's Hutz, the town groundskeeper."

Faraji can ask why he's still here.

>why are you still here
Faraji asks, "Why are you still here? The town is being flooded tomorrow."

"Had a feeling someone might come by looking for help. And here you are."

Faraji can ask how he can help them.

>l
Agent Faraji is in a dirty shack. Someone lives here, though not at all luxuriously. Plates are stacked up by the sink, and the whole place stinks of cat.

A stripey orange cat sits in a corner of the room, grooming itself.

Hutz is reclining on a narrow bed.

Also here is a sledgehammer.

Faraji can ask how he can help them.

>e
Agent Faraji is walking on Solvay Road by the lake. 

The seeming sound of sibilant speech carries on the breeze.

>w
Agent Faraji is in a dirty shack. Someone lives here, though not at all luxuriously. Plates are stacked up by the sink, and the whole place stinks of cat.

A mangy orange cat peeks out from under the bed.

Hutz is reclining on a narrow bed.

Also here is a sledgehammer.

>showme hutz
(Hutz)
Hutz - man
location: in the dirty shack
singular-named, proper-named, unmarked for special listing; unlit, inedible, portable, male, seen, familiar, quiet, background; adaptively-named
list grouping key: none
printed name: "Hutz"
printed plural name: "men"
indefinite article: "the"
most recent reference: nominal
third singular pronoun: He-pronoun
summary: none
description: "Hutz is more or less a skeleton in overalls."
initial appearance: "Hutz is reclining on a narrow bed."
dark description: none
hearability: very loud
volume: 0.0
price: $0
behind description: none
third-plural-pronoun: They-pronoun
possessive: none
portrait: Figure Hutz
carrying capacity: 100
behavior stack: Doing nothing
target location: Room of Subjects
remembrances: 
queue: 
first-singular-pronoun: I-pronoun
first-plural-pronoun: We-pronoun
second-singular-pronoun: Singular-you-pronoun
second-plural-pronoun: Plural-you-pronoun
person condition: met

* * *

>l
Agent Faraji is in a dirty shack. Someone lives here, though not at all luxuriously. Plates are stacked up by the sink, and the whole place stinks of cat.

A stripey orange cat sits in a corner of the room, grooming itself.

Hutz is reclining on a narrow bed.

Also here is a sledgehammer.

Faraji can ask how he can help them.

>how can you help them
"But how can you possibly help me?" Faraji asks.

"You're looking for the secret of Enigma Lake, are you not? The secret about to be lost forever? Something calls you here; you're searching for something, no, someone. Yes, yes, Hutz can help you."

>pet cat
The cat purrs and leans into Faraji's hand.

* * *

>l
Agent Faraji is in a dirty shack. Someone lives here, though not at all luxuriously. Plates are stacked up by the sink, and the whole place stinks of cat.

A stripey orange cat sits in a corner of the room, grooming itself.

Hutz is reclining on a narrow bed.

Also here is a sledgehammer.

Faraji can ask how he can help them.

>x old man
Hutz is more or less a skeleton in overalls.

>x groundskeeper
Hutz is more or less a skeleton in overalls.

>e
Agent Faraji is walking on Solvay Road by the lake.

>w
Agent Faraji is in a dirty shack. Someone lives here, though not at all luxuriously. Plates are stacked up by the sink, and the whole place stinks of cat.

A mangy orange cat peeks out from under the bed.

The bony old man is reclining on a narrow bed.

Also here is a sledgehammer.

>take hammer
There's nothing like that nearby.

* * *

>x groundskeeper
Hutz is more or less a skeleton in overalls.

>x cat
A mangy, old, stripey orange cat.

>x plates
Dirty and precariously stacked.

>pet cat
The cat purrs and leans into Faraji's hand.

>pet cat
The cat purrs and leans into Faraji's hand.

* * *

>gonear solvay main
Agent Faraji is on the corner of Main and Solvay. Main Street runs east from here, while Solvay Road heads north. South of here, Henry's Hot Skillet promises all of the comforts of the mid-twentieth-century diner. A book store named The Reading Room lies to the west, while Fresnel's Music is southwest.

>n
Agent Faraji is walking on Solvay Road 100 block. Solvay heads north and south. To the west is the fire station, while to the east is the side of the town hall.

>n
Agent Faraji is walking on Solvay Road leading out of town. Solvay Road bends here, leading northwest out of town and south back into town. East is the park, and to the west is Horton House.

>nw
Agent Faraji is walking on Solvay Road by the lake.

>e
Agent Faraji is at the west end of the town's lake shore.

>se
Faraji can't go that way.

>n
Faraji can't go that way.

>w
Agent Faraji is walking on Solvay Road by the lake.

>nw
That would take Faraji too far out of town.

The seeming sound of sibilant speech carries on the breeze.

>l
Agent Faraji is in Solvay Road by the lake.

>s
Faraji can't go that way.

>se
Faraji can't go that way.

* * *

>nw
That would take Faraji too far out of town.

The seeming sound of sibilant speech carries on the breeze.

>se
Agent Faraji is walking on Solvay Road leading out of town. Solvay Road bends here, leading northwest out of town and south back into town. East is the park, and to the west is Horton House.

>s
Agent Faraji is walking on Solvay Road 100 block. Solvay heads north and south. To the west is the fire station, while to the east is the side of the town hall.

>x fire
Which do you mean, the fire station, the fire station office door or Solvay Road by the fire station?

>station
Which do you mean, the fire station, the fire station office door or Solvay Road by the fire station?

>x door
There seems to be nothing special about it.

>x road
Agent Faraji is walking on Solvay Road by the fire station. Solvay heads north and south. To the west is the fire station, while to the east is the side of the town hall.

* * *

>s
Agent Faraji is walking on Solvay Road 100 block. Solvay heads north and south. To the west is the fire station, while to the east is the side of the town hall.

>x fire station
The sign over the big door says "Hook and Ladder Company #1". There is also a little door for people to come and go.

>w
(first opening the garage door)
It seems to be locked.

>x big door
There's nothing like that nearby.

>x garage door
There seems to be nothing special about it.

>gonear fire station
(the fire station)
Agent Faraji is walking on Solvay Road 100 block. Solvay heads north and south. To the west is the fire station, while to the east is the side of the town hall.

>gonear hook
There seems to be no such object anywhere in the model world.

>gonear ladder
Agent Faraji is in Hook and Ladder Company #1. 

Also here is a ladder.

>e
(first opening the garage door)
It seems to be locked.

* * *

>open hyundai
Faraji's job is here for now.

>open car
(Faraji's Hyundai)
Their job is here for now.

>enter it
Faraji's job is here for now.

>drive it
I'm not sure what you're trying to say. I might just not recognize the words you're using.

* * *

>x car
(Faraji's Hyundai)
An old bright red Hyundai Accent, it's been their personal means of transportation for years. And since the Bureau lost its fleet, it's their work car too.

>open it
It isn't something Faraji can open.

>drive car
I'm not sure what you're trying to say. I might just not recognize the words you're using.

>enter car
(Faraji's Hyundai)
Their job is here for now.