Department of Homeland Security, Washington, DC
Open on a drab office with decor dating to the mid-eighties. The DHS assistant to the associate sub-director looks longingly at the office clock nearing five, then leans across the desk and impatiently states his demands:

"First name, last name, pronouns?"

(1) Ezra Gaunt (he/him), winner of the 2006 Baltimore County Edgar Allan Poe Trivia Competition;

(2) Petula Clark Goldberg (she/her), former award-winning dog groomer of the avant-garde school;

or (3) Larch Faraji (they/them), lead singer of the third wave neo-old-school punk band DC Trash.

The Bureau of Strange Happenings
An Interactive Phenomenon by Phil Riley
Release 1 / Serial number 230515 / Inform 7 build 6M62 (I6/v6.34 lib 6/12N) SD

Agent Faraji is at the south end of the strip mall parking lot. From here one can see just how humble BOSH's state has become: the office is to the west, between a pawn shop (to the southwest) and a run-down laundromat (to the northwest) and across from an automatic car wash. To the south is a swampy area separating the lot from the interstate. The parking lot continues north.

Their Hyundai is parked nearby.

>1
Agent Gaunt is at the south end of the strip mall parking lot. From here one can see just how humble BOSH's state has become: the office is to the west, between a pawn shop (to the southwest) and a run-down laundromat (to the northwest) and across from an automatic car wash. To the south is a swampy area separating the lot from the interstate. The parking lot continues north.

His Hyundai is parked nearby.

>x car
(Gaunt's Hyundai)
An old bright red Hyundai Accent, it's been his personal means of transportation for years. And since the Bureau lost its fleet, it's his work car too.

* * *

>i
Faraji is carrying:
  the Bureau credit card
  a green smartphone

>i
Faraji is carrying:
  the Bureau credit card
  a green smartphone

>l
Agent Faraji is at the south end of the strip mall parking lot. From here one can see just how humble BOSH's state has become: the office is to the west, between a pawn shop (to the southwest) and a run-down laundromat (to the northwest) and across from an automatic car wash. To the south is a swampy area separating the lot from the interstate. The parking lot continues north.

Their Hyundai is parked nearby.

>showme your former self
There seems to be no such object anywhere in the model world.

>showme ten-dollar
ten-dollar bill - thing
location: carried by Faraji's former self in the Room of Stuff
singular-named, improper-named, unmarked for special listing; unlit, inedible, portable, handled, neuter, unseen, unfamiliar, quiet, background
list grouping key: none
printed name: "ten-dollar bill"
printed plural name: none
indefinite article: none
most recent reference: nominal
third singular pronoun: It-pronoun
summary: none
description: none
initial appearance: none
dark description: none
hearability: very loud
volume: 0.0
price: $0
behind description: none
third-plural-pronoun: They-pronoun
possessive: none
portrait: Figure Null

>who owns the case
There's nothing like that nearby.

>n
Faraji trudges to the other end of the parking lot. It's much like where they left.

Agent Faraji is at the north end of the strip mall parking lot. This end is no more auspicious than the other. A convenience store lies to the east. To the west is a military recruitment center. North of here the parking lot exits onto a busy road. There is a rusty sign by the road naming the shopping center: Park Place. South is BOSH headquarters, among other things.

* * *

>e
Faraji is greeted by a blast of music as they enter the store.

Agent Faraji is in the Li'l Nectarine Convenience Store. Li'l Nectarine offers great service and low prices, or so they say. This one's cluttered aisles and sparse shelves could make one wonder if that's true. Behind the counter is the typical array of cigarettes and lottery tickets. Under the counter is a glass case containing various useful items.

The clerk, a scruffy man in his mid-twenties, is leaning against the counter, looking bored.

>who owns clerk
No one owns the store clerk.

>who owns the case
No one owns the glass case.

>who owns the flashlight
The store clerk owns the flashlight.

>x counter
There seems to be nothing special about it.

* * *

>l
Agent Faraji is at the south end of the strip mall parking lot. From here one can see just how humble BOSH's state has become: the office is to the west, between a pawn shop (to the southwest) and a run-down laundromat (to the northwest) and across from an automatic car wash. To the south is a swampy area separating the lot from the interstate. The parking lot continues north.

Their Hyundai is parked nearby.

>x hq
Faraji gazes stoically at the sad little storefront that is the new BOSH office. The sign from the previous tenant is still up: "Angel's Department Store". Through the front window can be seen Margaret, in her usual manic work mode.

* * *

>n
Faraji trudges to the other end of the parking lot. It's much like where they left.

Agent Faraji is at the north end of the strip mall parking lot. This end is no more auspicious than the other. A convenience store lies to the east. To the west is a military recruitment center. North of here the parking lot exits onto a busy road. There is a rusty sign by the road naming the shopping center: Park Place. South is BOSH headquarters, among other things.

* * *

>e
Faraji is greeted by a blast of music as they enter the store.

Agent Faraji is in the Li'l Nectarine Convenience Store. Li'l Nectarine offers great service and low prices, or so they say. This one's cluttered aisles and sparse shelves could make one wonder if that's true. Behind the counter is the typical array of cigarettes and lottery tickets. Under the counter is a glass case containing various useful items.

The clerk, a scruffy man in his mid-twenties, is leaning against the counter, looking bored.

>ask about case
"You want something? Name it."

>ask clerk about case
"You want something? Name it."

>actions
Actions listing on.

>ask clerk about case
[quizzing the store clerk about the glass case]
That doesn't seem to be a topic of conversation at the moment.
[quizzing the store clerk about the glass case - failed the check quizzing someone about something]

* * *

>ask clerk about case
"You want something? Name it."

>ask clerk about card
That doesn't seem to be a topic of conversation at the moment.

>ask about screwdriver
That doesn't seem to be a topic of conversation at the moment.

>tell clerk about case
That doesn't seem to be a topic of conversation at the moment.

>ask clerk for case
That doesn't seem to be a topic of conversation at the moment.

>x aisle
Faraji hardly needs bread, ketchup, or potato chips.

>x bread
There's nothing like that nearby.

>x flashlight
The flashlight is currently switched off.

>x torc
There's nothing like that nearby.

>x torch
The flashlight is currently switched off.

>take it
The glass case isn't open.

* * *

>e
Faraji is greeted by a blast of music as they enter the store.

Agent Faraji is in the Li'l Nectarine Convenience Store. Li'l Nectarine offers great service and low prices, or so they say. This one's cluttered aisles and sparse shelves could make one wonder if that's true. Behind the counter is the typical array of cigarettes and lottery tickets. Under the counter is a glass case containing various useful items.

The clerk, a scruffy man in his mid-twenties, is leaning against the counter, looking bored.

>out
Faraji exits the store into the relative quiet of the nearby traffic.

Agent Faraji is at the north end of the strip mall parking lot. This end is no more auspicious than the other. A convenience store lies to the east. To the west is a military recruitment center. North of here the parking lot exits onto a busy road. There is a rusty sign by the road naming the shopping center: Park Place. South is BOSH headquarters, among other things.

>out
But Faraji isn't in anything at the moment.

* * *

>out
Faraji exits the store into the relative quiet of the nearby traffic.

Agent Faraji is at the north end of the strip mall parking lot. This end is no more auspicious than the other. A convenience store lies to the east. To the west is a military recruitment center. North of here the parking lot exits onto a busy road. There is a rusty sign by the road naming the shopping center: Park Place. South is BOSH headquarters, among other things.

>x center
There's nothing like that nearby.

>w
Faraji will think about joining the military once the Bureau shuts down.

* * *

>e
Faraji is greeted by a blast of music as they enter the store.

Agent Faraji is in the Li'l Nectarine Convenience Store. Li'l Nectarine offers great service and low prices, or so they say. This one's cluttered aisles and sparse shelves could make one wonder if that's true. Behind the counter is the typical array of cigarettes and lottery tickets. Under the counter is a glass case containing various useful items.

The clerk, a scruffy man in his mid-twenties, is leaning against the counter, looking bored.

>x aisles
There's nothing like that nearby.

>x shelves
Faraji hardly needs bread, ketchup, or potato chips.

* * *

>x case
In the glass case are a flashlight, a red screwdriver, a laptop computer and some wireless earbuds.

>x array
There's nothing like that nearby.

>x items
In the glass case are a flashlight, a red screwdriver, a laptop computer and some wireless earbuds.

>x flashlight
The flashlight is currently switched off.

>x screwdrover
There's nothing like that nearby.

>oops screwdriver
A medium-length flat head screwdriver with a red plastic handle.

>x laptop
A knockoff of a fancy gaming laptop.

>x notebook
A knockoff of a fancy gaming laptop.

>x airpods
Some no-name brand.

>x clerk
The clerk looks as if he'd rather be anywhere else. He's wearing jeans and a white t-shirt with something inscrutable scrawled on it. His hair sticks up every which way.

>l
Agent Faraji is in the Li'l Nectarine Convenience Store. Li'l Nectarine offers great service and low prices, or so they say. This one's cluttered aisles and sparse shelves could make one wonder if that's true. Behind the counter is the typical array of cigarettes and lottery tickets. Under the counter is a glass case containing various useful items.

The clerk, a scruffy man in his mid-twenties, is leaning against the counter, looking bored.

>x handle
A medium-length flat head screwdriver with a red plastic handle.

>w
Faraji exits the store into the relative quiet of the nearby traffic.

Agent Faraji is at the north end of the strip mall parking lot. This end is no more auspicious than the other. A convenience store lies to the east. To the west is a military recruitment center. North of here the parking lot exits onto a busy road. There is a rusty sign by the road naming the shopping center: Park Place. South is BOSH headquarters, among other things.

* * *

>w
Faraji will think about joining the military once the Bureau shuts down.

>x center
Patriotic posters paper the windows.

>x posters
The new slogan is "Answer the Call!"

>x slogan
The new slogan is "Answer the Call!"

>l
Agent Faraji is at the north end of the strip mall parking lot. This end is no more auspicious than the other. A convenience store lies to the east. To the west is a military recruitment center. North of here the parking lot exits onto a busy road. There is a rusty sign by the road naming the shopping center: Park Place. South is BOSH headquarters, among other things.

>x road
The main business thoroughfare of Swamp Park.

>x swamp park
There's nothing like that nearby.

>x park
Agent Faraji is at the north end of the strip mall parking lot. This end is no more auspicious than the other. A convenience store lies to the east. To the west is a military recruitment center. North of here the parking lot exits onto a busy road. There is a rusty sign by the road naming the shopping center: Park Place. South is BOSH headquarters, among other things.

>x bosh hq
The BOSH headquarters are to the south.

>x convenience store
It's marked by a sign with a big nectarine on it.

>x nectarine
It's marked by a sign with a big nectarine on it.

>x lot
Agent Faraji is at the north end of the strip mall parking lot. This end is no more auspicious than the other. A convenience store lies to the east. To the west is a military recruitment center. North of here the parking lot exits onto a busy road. There is a rusty sign by the road naming the shopping center: Park Place. South is BOSH headquarters, among other things.

>s
Faraji walks back to the south end of the parking lot.

Agent Faraji is at the south end of the strip mall parking lot. From here one can see just how humble BOSH's state has become: the office is to the west, between a pawn shop (to the southwest) and a run-down laundromat (to the northwest) and across from an automatic car wash. To the south is a swampy area separating the lot from the interstate. The parking lot continues north.

Their Hyundai is parked nearby.

>sw
(first opening the pawn shop door)
"Cha-ching!" rings the electronic chime as Faraji steps into the store.

Agent Faraji is in the Dave's pawn shop. This is more the seedy, gloomy stereotype of a pawn shop than the glitzy sanitized version of TV reality shows. The blinds in the windows are closed to only allow the barest slant of sunlight in, leaving the sickly fluorescent lights to illuminate the room. There is the distinct smell of cigar smoke. The glass counter is filled with a large collection of possibly valuable items. Behind it is an impressive array of firearms.

Also here is the pawn shop owner.

Faraji can ask for a screwdriver.

>nw
Faraji can't go that way.

They can ask for a screwdriver.

>sw
Faraji can't go that way.

They can ask for a screwdriver.

* * *

>e
Faraji is greeted by a blast of music as they enter the store.

Agent Faraji is in the Li'l Nectarine Convenience Store. Li'l Nectarine offers great service and low prices, or so they say. This one's cluttered aisles and sparse shelves could make one wonder if that's true. Behind the counter is the typical array of cigarettes and lottery tickets. Under the counter is a glass case containing various useful items.

The clerk, a scruffy man in his mid-twenties, is leaning against the counter, looking bored.

>x cigarettes
Which do you mean, the assorted goods or the cigarettes?

>cigarettes
Which do you mean, the assorted goods or the cigarettes?

* * *

>e
Faraji is greeted by a blast of music as they enter the store.

Agent Faraji is in the Li'l Nectarine Convenience Store. Li'l Nectarine offers great service and low prices, or so they say. This one's cluttered aisles and sparse shelves could make one wonder if that's true. Behind the counter is the typical array of cigarettes and lottery tickets. Under the counter is a glass case containing various useful items.

The clerk, a scruffy man in his mid-twenties, is leaning against the counter, looking bored.

>x counter
The counter is arrayed with displays of CBD oil, antacids, and the like.

>x cbd
Faraji doesn't need any of this stuff.

>x antacids
Faraji feels fine for now.

>x cigarettes
Faraji has no interest in smoking.

>x tickets
Faraji feels no urge to gamble.

>x case
In the glass case are a flashlight, a red screwdriver, a laptop computer, some wireless earbuds and a black smart phone.

>x items
There's nothing like that nearby.

>x flashlight
The flashlight is currently switched off.

>x screwdriver
There seems to be nothing special about it.

>x computer
There seems to be nothing special about it.

>x earbuds
There seems to be nothing special about them.

>x phone
(the green smartphone)
It's a pretty nice phone, only a couple of years old, but Faraji doesn't have time to play with it. They need to get to the office.

>x black phone
There seems to be nothing special about it.

>w
Faraji exits the store into the relative quiet of the nearby traffic.

Agent Faraji is at the north end of the strip mall parking lot. This end is no more auspicious than the other. A convenience store lies to the east. To the west is a military recruitment center. North of here the parking lot exits onto a busy road. There is a rusty sign by the road naming the shopping center: Park Place. South is BOSH headquarters, among other things.

* * *

>s
Faraji walks back to the south end of the parking lot.

Agent Faraji is at the south end of the strip mall parking lot. From here one can see just how humble BOSH's state has become: the office is to the west, between a pawn shop (to the southwest) and a run-down laundromat (to the northwest) and across from an automatic car wash. To the south is a swampy area separating the lot from the interstate. The parking lot continues north.

Their Hyundai is parked nearby.

>w
Just like in the store this once was, the door chimes as Faraji walks in.

Agent Faraji is in the front office. It's really a small storefront done up to resemble an office. A store sales counter serves as a front desk, behind which are located shelves of office supplies and a row of drawers. There are also a couch and coffee table here creating a makeshift seating area. An old department store clothing rack serves as a coatrack. Photos on the walls picture the Bureau in better days. A stack of used and empty cardboard boxes sits in one corner.

The Bureau's latest office manager, Margaret is bustling around with unrestrained enthusiasm, unpacking boxes and assembling an approximation of a respectable front office, all as if the Bureau isn't going to be shut down before the year is out. She sees Faraji and practically squeals. "Agent Faraji! I'm sorry -- Larch! How are you? I hope you don't mind -- I took the liberty of putting your desk together. I just love hex wrenches, don't you? Also, your new phone is here. I put it in your desk. Good timing! Now I just need you to give me your old phone so I can deactivate it."

Faraji hands Margaret their old phone. Margaret taps a few keys on her computer and says "There! All settled. Hey, what are you doing for lunch? Let me know when you get hungry!"

A phone is ringing not too far away.

Faraji can ask about the new phone.

>x vemt
There's nothing like that nearby.

>x vent
A typical vent with a grill which one would hope would stop things like, say, a hex wrench from falling through. It's set in the floor behind the front desk. The vent is held closed by four screws.

In the heating vent is a hex wrench.

A phone is ringing not too far away.

Faraji can ask about the new phone or ask for a screwdriver.

>x screws
There's nothing like that nearby.

* * *

>n
Faraji trudges to the other end of the parking lot. It's much like where they left.

Agent Faraji is at the north end of the strip mall parking lot. This end is no more auspicious than the other. A convenience store lies to the east. To the west is a military recruitment center. North of here the parking lot exits onto a busy road. There is a rusty sign by the road naming the shopping center: Park Place. South is BOSH headquarters, among other things.

>enter military
Faraji will think about joining the military once the Bureau shuts down.

>fuck
I'm not sure what you're trying to say. I might just not recognize the words you're using.

>xyzzy
I'm not sure what you're trying to say. I might just not recognize the words you're using.

* * *

>n
Faraji trudges to the other end of the parking lot. It's much like where they left.

Agent Faraji is at the north end of the strip mall parking lot. This end is no more auspicious than the other. A convenience store lies to the east. To the west is a military recruitment center. North of here the parking lot exits onto a busy road. There is a rusty sign by the road naming the shopping center: Park Place. South is BOSH headquarters, among other things.

>enter store
Faraji is greeted by a blast of music as they enter the store.

Agent Faraji is in the Li'l Nectarine Convenience Store. Li'l Nectarine offers great service and low prices, or so they say. This one's cluttered aisles and sparse shelves could make one wonder if that's true. Behind the counter is the typical array of cigarettes and lottery tickets. Under the counter is a glass case containing various useful items.

The clerk, a scruffy man in his mid-twenties, is leaning against the counter, looking bored.

>out
But Faraji isn't in anything at the moment.

* * *

>n
Faraji trudges to the other end of the parking lot. It's much like where they left.

Agent Faraji is at the north end of the strip mall parking lot. This end is no more auspicious than the other. A convenience store lies to the east. To the west is a military recruitment center. North of here the parking lot exits onto a busy road. There is a rusty sign by the road naming the shopping center: Park Place. South is BOSH headquarters, among other things.

>n
Faraji has things to do here.

>w
Faraji will think about joining the military once the Bureau shuts down.

>e
Faraji is greeted by a blast of music as they enter the store.

Agent Faraji is in the Li'l Nectarine Convenience Store. Li'l Nectarine offers great service and low prices, or so they say. This one's cluttered aisles and sparse shelves could make one wonder if that's true. Behind the counter is the typical array of cigarettes and lottery tickets. Under the counter is a glass case containing various useful items.

The clerk, a scruffy man in his mid-twenties, is leaning against the counter, looking bored.

>w
Faraji exits the store into the relative quiet of the nearby traffic.

Agent Faraji is at the north end of the strip mall parking lot. This end is no more auspicious than the other. A convenience store lies to the east. To the west is a military recruitment center. North of here the parking lot exits onto a busy road. There is a rusty sign by the road naming the shopping center: Park Place. South is BOSH headquarters, among other things.

>x sign
It says "Park Place".

>hit sign
Violence isn't the answer to this one.

>hit military
Violence isn't the answer to this one.

>lick it
I'm not sure what you're trying to say. I might just not recognize the words you're using.

>tast military
I'm not sure what you're trying to say. I might just not recognize the words you're using.

>taste military
Faraji tastes nothing unexpected.

>feel military
Faraji feels nothing unexpected.

* * *

>n
Faraji trudges to the other end of the parking lot. It's much like where they left.

Agent Faraji is at the north end of the strip mall parking lot. This end is no more auspicious than the other. A convenience store lies to the east. To the west is a military recruitment center. North of here the parking lot exits onto a busy road. There is a rusty sign by the road naming the shopping center: Park Place. South is BOSH headquarters, among other things.

>x bosh
The BOSH headquarters are to the south.

>s
Faraji walks back to the south end of the parking lot.

Agent Faraji is at the south end of the strip mall parking lot. From here one can see just how humble BOSH's state has become: the office is to the west, between a pawn shop (to the southwest) and a run-down laundromat (to the northwest) and across from an automatic car wash. To the south is a swampy area separating the lot from the interstate. The parking lot continues north.

Their Hyundai is parked nearby.

>x bosh
Faraji gazes stoically at the sad little storefront that is the new BOSH office. The sign from the previous tenant is still up: "Angel's Department Store". Through the front window can be seen Margaret, in her usual manic work mode.

>x margaret
Even from here you can sense Margaret's irrepressible energy.

* * *

>n
Faraji trudges to the other end of the parking lot. It's much like where they left.

Agent Faraji is at the north end of the strip mall parking lot. This end is no more auspicious than the other. A convenience store lies to the east. To the west is a military recruitment center. North of here the parking lot exits onto a busy road. There is a rusty sign by the road naming the shopping center: Park Place. South is BOSH headquarters, among other things.

>x store
There seems to be nothing special about it.

>e
Faraji is greeted by a blast of music as they enter the store.

Agent Faraji is in the Li'l Nectarine Convenience Store. Li'l Nectarine offers great service and low prices, or so they say. This one's cluttered aisles and sparse shelves could make one wonder if that's true. Behind the counter is the typical array of cigarettes and lottery tickets. Under the counter is a glass case containing various useful items.

The clerk, a scruffy man in his mid-twenties, is leaning against the counter, looking bored.

* * *

>w
Faraji exits the store into the relative quiet of the nearby traffic.

Agent Faraji is at the north end of the strip mall parking lot. This end is no more auspicious than the other. A convenience store lies to the east. To the west is a military recruitment center. North of here the parking lot exits onto a busy road. There is a rusty sign by the road naming the shopping center: Park Place. South is BOSH headquarters, among other things.

>enter store
You can't enter that.

* * *

>playtest
>> x bosh
>> x laundromat sign
>> x dave's pawn shop
>> x neon sign

I beg your pardon?

>l
Agent Faraji is at the south end of the strip mall parking lot. From here one can see just how humble BOSH's state has become: the office is to the west, between a pawn shop (to the southwest) and a run-down laundromat (to the northwest) and across from an automatic car wash. To the south is a swampy area separating the lot from the interstate. The parking lot continues north.

Their Hyundai is parked nearby.

Assertion failed: produced ">", not "Faraji observes the pawn shop with obvious distaste. The flashing neon sign in the window advertises "Cash for gold!""!
>> x neon sign
Its flash rate is just a bit over the threshold of irritating.

>;
I'm not sure what you're trying to say. I might just not recognize the words you're using.

>l
Agent Faraji is at the south end of the strip mall parking lot. From here one can see just how humble BOSH's state has become: the office is to the west, between a pawn shop (to the southwest) and a run-down laundromat (to the northwest) and across from an automatic car wash. To the south is a swampy area separating the lot from the interstate. The parking lot continues north.

Their Hyundai is parked nearby.

* * *

I beg your pardon?

>l
Agent Faraji is at the south end of the strip mall parking lot. From here one can see just how humble BOSH's state has become: the office is to the west, between a pawn shop (to the southwest) and a run-down laundromat (to the northwest) and across from an automatic car wash. To the south is a swampy area separating the lot from the interstate. The parking lot continues north.

Their Hyundai is parked nearby.

Also here are a pawn shop door and a laundromat door.

processing started.
Assertion failed: produced ">", not "foo"!

* * *

I beg your pardon?

>playtest
Assertion failed: produced "Which do you mean, the department store sign, the laundromat sign or the flashing neon sign?[paragraph break]>", not "Faraji gazes stoically at the sad little storefront that is the new BOSH office. The sign from the previous tenant is still up: "Angel's Department Store". Through the front window can be seen Margaret, in her usual manic work mode."!
Evaluating: x bosh
Faraji gazes stoically at the sad little storefront that is the new BOSH office. The sign from the previous tenant is still up: "Angel's Department Store". Through the front window can be seen Margaret, in her usual manic work mode.
Evaluating: x sign

I beg your pardon?

>;
I'm not sure what you're trying to say. I might just not recognize the words you're using.
processing started.
>

* * *

I beg your pardon?

>l
Agent Faraji is at the south end of the strip mall parking lot. From here one can see just how humble BOSH's state has become: the office is to the west, between a pawn shop (to the southwest) and a run-down laundromat (to the northwest) and across from an automatic car wash. To the south is a swampy area separating the lot from the interstate. The parking lot continues north.

Their Hyundai is parked nearby.

Also here are a pawn shop door and a laundromat door.

processing started.
Assertion failed: produced "Faraji gazes stoically at the sad little storefront that is the new BOSH office. The sign from the previous tenant is still up: "Angel's Department Store". Through the front window can be seen Margaret, in her usual manic work mode.", not "foo"!

* * *

I beg your pardon?

>playtest
processing started.
Assertion failed: produced "[line break]Which do you mean, the department store sign, the laundromat sign or the flashing neon sign?[paragraph break]>", not "Faraji gazes stoically at the sad little storefront that is the new BOSH office. The sign from the previous tenant is still up: "Angel's Department Store". Through the front window can be seen Margaret, in her usual manic work mode."!
2.
Evaluating: x bosh
expected: Faraji gazes stoically at the sad little storefront that is the new BOSH office. The sign from the previous tenant is still up: "Angel's Department Store". Through the front window can be seen Margaret, in her usual manic work mode..
processing started.
Assertion failed: produced "[line break]Faraji gazes stoically at the sad little storefront that is the new BOSH office. The sign from the previous tenant is still up: "Angel's Department Store". Through the front window can be seen Margaret, in her usual manic work mode.", not "Faraji gazes stoically at the sad little storefront that is the new BOSH office. The sign from the previous tenant is still up: "Angel's Department Store". Through the front window can be seen Margaret, in her usual manic work mode."!
1.
Evaluating: x sign
expected: Faraji gazes stoically at the sad little storefront that is the new BOSH office. The sign from the previous tenant is still up: "Angel's Department Store". Through the front window can be seen Margaret, in her usual manic work mode..

* * *

I beg your pardon?

>read sign
foo bar> enter bosh

>read sign
foo bar>> ask about phone

* * *

I beg your pardon?

>restart
Are you sure you want to restart?

>y
Department of Homeland Security, Washington, DC
Open on a drab office with decor dating to the mid-eighties. The DHS assistant to the associate sub-director looks longingly at the office clock nearing five, then leans across the desk and impatiently states his demands:

"First name, last name, pronouns?"

(1) Ezra Gaunt (he/him), winner of the 2006 Baltimore County Edgar Allan Poe Trivia Competition;

(2) Petula Clark Goldberg (she/her), former award-winning dog groomer of the avant-garde school;

or (3) Larch Faraji (they/them), lead singer of the third wave neo-old-school punk band DC Trash.

The Bureau of Strange Happenings
An Interactive Phenomenon by Phil Riley
Release 1 / Serial number 230510 / Inform 7 build 6M62 (I6/v6.34 lib 6/12N) SD

Agent Faraji is at the south end of the strip mall parking lot. From here one can see just how humble BOSH's state has become: the office is to the west, between a pawn shop (to the southwest) and a run-down laundromat (to the northwest) and across from an automatic car wash. To the south is a swampy area separating the lot from the interstate. The parking lot continues north.

Their Hyundai is parked nearby.

Also here are a pawn shop door and a laundromat door.

>rules
Rules tracing now switched on. Type "rules off" to switch it off again, or "rules all" to include even rules which do not apply.

[Rule "clear LPR rule" applies.]
[Rule "reset skip sounds rule" applies.]

>playtest
[Rule "redirect to GEP line input rule" applies.]
[Rule "ordinary checking for content rule" applies.]
[Rule "After reading a command" applies.]
[Rule "declare everything initially unmentioned rule" applies.]
[Rule "investigate player's awareness before action rule" applies.]
[Rule "player aware of his own actions rule" applies.]
[Rule "check stage rule" applies.]
[Rule "carry out stage rule" applies.]
[Rule "Carry out ptesting" applies.]
[Rule "for playtesting" applies.]
[Rule "after stage rule" applies.]
[Rule "investigate player's awareness after action rule" applies.]
[Rule "report stage rule" applies.]
[Rule "last specific action-processing rule" applies.]
[Rule "clear LPR rule" applies.]
[Rule "reset skip sounds rule" applies.]
[Rule "Command Unit Testing execute queued commands rule" applies.]
Evaluating: x bosh
processing started.
Assertion failed: produced "[Rule "After reading a command" applies.][line break][Rule "place the room in scope while looking rule" applies.][line break][Rule "declare everything initially unmentioned rule" applies.][line break][Rule "announce items from multiple object lists rule" applies.][line break][Rule "set pronouns from items from multiple object lists rule" applies.][line break][Rule "before stage rule" applies.][line break][Rule "can't act in the dark rule" applies.][line break][Rule "instead stage rule" applies.][line break][Rule "investigate player's awareness before action rule" applies.][line break][Rule "player aware ", not "Faraji gazes stoically at the sad little storefront that is the new BOSH office. The sign from the previous tenant is still up: "Angel's Department Store". Through the front window can be seen Margaret, in her usual manic work mode."!
[Rule "For post "x bosh"" applies.]
1.
[Rule "clear LPR rule" applies.]
[Rule "reset skip sounds rule" applies.]
[Rule "Command Unit Testing execute queued commands rule" applies.]
Evaluating: x sign

[Rule "redirect to GEP line input rule" applies.]
[Rule "ordinary checking for content rule" applies.]
I beg your pardon?

* * *

>restart
[Rule "redirect to GEP line input rule" applies.]
[Rule "ordinary checking for content rule" applies.]
[Rule "After reading a command" applies.]
[Rule "declare everything initially unmentioned rule" applies.]
[Rule "investigate player's awareness before action rule" applies.]
[Rule "player aware of his own actions rule" applies.]
[Rule "check stage rule" applies.]
[Rule "carry out stage rule" applies.]
Are you sure you want to restart?

>y
[Rule "redirect to GEP line input rule" applies.]

[Rule "ordinary checking for content rule" applies.]

Department of Homeland Security, Washington, DC
Open on a drab office with decor dating to the mid-eighties. The DHS assistant to the associate sub-director looks longingly at the office clock nearing five, then leans across the desk and impatiently states his demands:

"First name, last name, pronouns?"

(1) Ezra Gaunt (he/him), winner of the 2006 Baltimore County Edgar Allan Poe Trivia Competition;

(2) Petula Clark Goldberg (she/her), former award-winning dog groomer of the avant-garde school;

or (3) Larch Faraji (they/them), lead singer of the third wave neo-old-school punk band DC Trash.

The Bureau of Strange Happenings
An Interactive Phenomenon by Phil Riley
Release 1 / Serial number 230510 / Inform 7 build 6M62 (I6/v6.34 lib 6/12N) SD

Agent Faraji is at the south end of the strip mall parking lot. From here one can see just how humble BOSH's state has become: the office is to the west, between a pawn shop (to the southwest) and a run-down laundromat (to the northwest) and across from an automatic car wash. To the south is a swampy area separating the lot from the interstate. The parking lot continues north.

Their Hyundai is parked nearby.

Also here are a pawn shop door and a laundromat door.

>playtest
Evaluating: x bosh
processing started.
Faraji gazes stoically at the sad little storefront that is the new BOSH office. The sign from the previous tenant is still up: "Angel's Department Store". Through the front window can be seen Margaret, in her usual manic work mode.
1.
Evaluating: x sign

I beg your pardon?

>l
Agent Faraji is at the south end of the strip mall parking lot. From here one can see just how humble BOSH's state has become: the office is to the west, between a pawn shop (to the southwest) and a run-down laundromat (to the northwest) and across from an automatic car wash. To the south is a swampy area separating the lot from the interstate. The parking lot continues north.

Their Hyundai is parked nearby.

Also here are a pawn shop door and a laundromat door.

processing started.
Assertion failed: produced "Which do you mean, the department store sign, the laundromat sign or the flashing neon sign?[paragraph break]>", not "Faraji gazes stoically at the sad little storefront that is the new BOSH office. The sign from the previous tenant is still up: "Angel's Department Store". Through the front window can be seen Margaret, in her usual manic work mode."!
2.

* * *

>playtest
>> x bosh
>> x laundromat sign
>> x dave's pawn shop
>> x neon sign

>laundromat
It's just a piece of stationery marked up with Sharpie and taped to the door.

processing started.
Assertion failed: produced "", not "Faraji gazes stoically at the sad little storefront that is the new BOSH office. The sign from the previous tenant is still up: "Angel's Department Store". Through the front window can be seen Margaret, in her usual manic work mode."!
Evaluating: laundromat
I'm not sure what you're trying to say. I might just not recognize the words you're using.
processing started.
Assertion failed: produced "", not "foo"!

* * *

>playtest
>> x bosh
>> x laundromat sign
>> x dave's pawn shop
>> x neon sign

>playtest
Assertion failed: produced "Which do you mean, the department store sign, the laundromat sign or the flashing neon sign?[paragraph break]>", not "Faraji gazes stoically at the sad little storefront that is the new BOSH office. The sign from the previous tenant is still up: "Angel's Department Store". Through the front window can be seen Margaret, in her usual manic work mode."!
Evaluating: x bosh
Faraji gazes stoically at the sad little storefront that is the new BOSH office. The sign from the previous tenant is still up: "Angel's Department Store". Through the front window can be seen Margaret, in her usual manic work mode.
Evaluating: x sign

* * *

I beg your pardon?

>rules
Rules tracing now switched on. Type "rules off" to switch it off again, or "rules all" to include even rules which do not apply.

[Rule "Command Unit Testing process current assertion after the command finishes rule" applies.]
Assertion failed: produced "Which do you mean, the department store sign, the laundromat sign or the flashing neon sign?[paragraph break]>", not "Faraji gazes stoically at the sad little storefront that is the new BOSH office. The sign from the previous tenant is still up: "Angel's Department Store". Through the front window can be seen Margaret, in her usual manic work mode."!
[Rule "For post "x sign"" applies.]
[Rule "clear LPR rule" applies.]
[Rule "reset skip sounds rule" applies.]

>playtest
[Rule "redirect to GEP line input rule" applies.]
[Rule "ordinary checking for content rule" applies.]
[Rule "After reading a command" applies.]
[Rule "declare everything initially unmentioned rule" applies.]
[Rule "investigate player's awareness before action rule" applies.]
[Rule "player aware of his own actions rule" applies.]
[Rule "check stage rule" applies.]
[Rule "carry out stage rule" applies.]
[Rule "Carry out ptesting" applies.]
[Rule "for playtesting" applies.]
[Rule "after stage rule" applies.]
[Rule "investigate player's awareness after action rule" applies.]
[Rule "report stage rule" applies.]
[Rule "last specific action-processing rule" applies.]
[Rule "clear LPR rule" applies.]
[Rule "reset skip sounds rule" applies.]
[Rule "Command Unit Testing execute queued commands rule" applies.]
Evaluating: x bosh
Assertion failed: produced "[Rule "After reading a command" applies.][line break][Rule "place the room in scope while looking rule" applies.][line break][Rule "declare everything initially unmentioned rule" applies.][line break][Rule "announce items from multiple object lists rule" applies.][line break][Rule "set pronouns from", not "Faraji gazes stoically at the sad little storefront that is the new BOSH office. The sign from the previous tenant is still up: "Angel's Department Store". Through the front window can be seen Margaret, in her usual manic work mode."!
[Rule "For post "x bosh"" applies.]
[Rule "clear LPR rule" applies.]
[Rule "reset skip sounds rule" applies.]
[Rule "Command Unit Testing execute queued commands rule" applies.]
Evaluating: x sign

[Rule "redirect to GEP line input rule" applies.]
[Rule "ordinary checking for content rule" applies.]
I beg your pardon?

* * *

>playtest
>> x bosh
>> x laundromat sign
>> x dave's pawn shop
>> x neon sign

>x laundromat
Which do you mean, the laundromat door, the A-plus laundromat or the laundromat sign?

>laundromat
Which do you mean, the laundromat door, the A-plus laundromat or the laundromat sign?

>sign
It's just a piece of stationery marked up with Sharpie and taped to the door. It says "Closed for renovations".

* * *

>playtest
>> x bosh
>> x laundromat sign
>> x dave's pawn shop
>> x neon sign

>x pawn
(the pawn shop door)
It's a typical glass door. The light within is too dim to see much.

>x pawn shop store
There's nothing like that nearby.

>showme
south end of the strip mall parking lot - room
    Hyperlight - backdrop
    Faraji - nonbinary
        Bureau credit card - money card
        green smartphone - phone
    pawn shop door - closed door
    laundromat door - locked door
    office - unenterable room
        Margaret at a distance (part of office)
        department store sign (part of office)
    their Hyundai
    laundromat - unenterable room
        laundromat sign (part of laundromat)
    swamp - unenterable room
    pawn shop - unenterable room
        flashing neon sign (part of pawn shop)
    automatic car wash - unenterable room
    interstate

>x sign
Which do you mean, the department store sign, the laundromat sign or the flashing neon sign?

>neon
Its flash rate is just a bit over the threshold of irritating.

>x flashing
Its flash rate is just a bit over the threshold of irritating.

>x gold
Its flash rate is just a bit over the threshold of irritating.

>x car wasj
There's nothing like that nearby.

>x car wash
Much like any other automatic car wash.

>enter it
An automatic car wash isn't of much use when one is on foot.

>enter pawn shop
(the pawn shop door)
(first opening the pawn shop door)
Faraji's not that desperate -- yet.

>x laundromat
(the laundromat door)
It's a typical glass door. Taped to it is a sign that says "Closed for renovations".

>l
Agent Faraji is at the south end of the strip mall parking lot. From here one can see just how humble BOSH's state has become: the office is to the west, between a pawn shop (to the southwest) and a run-down laundromat (to the northwest) and across from an automatic car wash. To the south is a swampy area separating the lot from the interstate. The parking lot continues north.

Their Hyundai is parked nearby.

Also here are a pawn shop door and a laundromat door.

* * *

>playtest
>> x bosh
>> x laundromat sign
>> x dave's pawn shop
>> x neon sign

>x sign
Which do you mean, the department store sign, the laundromat sign or the flashing neon sign?
foo982040

>neon
Its flash rate is just a bit over the threshold of irritating.

* * *

>playtest
>> x bosh
>> x laundromat sign
>> x dave's pawn shop
>> x neon sign

>z
Faraji stands around and waits.

>l
Agent Faraji is at the south end of the strip mall parking lot. From here one can see just how humble BOSH's state has become: the office is to the west, between a pawn shop (to the southwest) and a run-down laundromat (to the northwest) and across from an automatic car wash. To the south is a swampy area separating the lot from the interstate. The parking lot continues north.

Their Hyundai is parked nearby.

Also here are a pawn shop door and a laundromat door.

>playtest
>> x bosh
Faraji gazes stoically at the sad little storefront that is the new BOSH office. The sign from the previous tenant is still up: "Angel's Department Store". Through the front window can be seen Margaret, in her usual manic work mode.

* * *

>playtet
I'm not sure what you're trying to say. I might just not recognize the words you're using.

>playtest
>> x bosh 
>> x laundromat sign 
>> x dave's pawn shop 
>> x neon sign

* * *

>plytest
I'm not sure what you're trying to say. I might just not recognize the words you're using.

>playtest
>> x bosh
Faraji gazes stoically at the sad little storefront that is the new BOSH office. The sign from the previous tenant is still up: "Angel's Department Store". Through the front window can be seen Margaret, in her usual manic work mode.
>> x sign
> laundromat

[** Programming error: tried to write to ->264 in the buffer array "buffer", which has entries 4 up to 263 **]

[** Programming error: tried to write to ->265 in the buffer array "buffer", which has entries 4 up to 263 **]

[** Programming error: tried to read from ->264 in the buffer array "buffer2", which has entries 4 up to 263 **]

[** Programming error: tried to write to ->266 in the buffer array "buffer", which has entries 4 up to 263 **]

[** Programming error: tried to write to ->266 in the buffer array "buffer", which has entries 4 up to 263 **]
There's nothing like that nearby.
>> x dave's pawn shop
Faraji observes the pawn shop with obvious distaste. The flashing neon sign in the window advertises "Cash for gold!"
>> x neon sign
Its flash rate is just a bit over the threshold of irritating.

* * *

>rules
Rules tracing now switched on. Type "rules off" to switch it off again, or "rules all" to include even rules which do not apply.

[Rule "clear LPR rule" applies.]
[Rule "reset skip sounds rule" applies.]

* * *

>s
The swamp would just muck up Agent Faraji's clothes.

>restart
Are you sure you want to restart?

>y
Department of Homeland Security, Washington, DC
Open on a drab office with decor dating to the mid-eighties. The DHS assistant to the associate sub-director looks longingly at the office clock nearing five, then leans across the desk and impatiently states his demands:

"First name, last name, pronouns?"

(1) Ezra Gaunt (he/him), winner of the 2006 Baltimore County Edgar Allan Poe Trivia Competition;

(2) Petula Clark Goldberg (she/her), former award-winning dog groomer of the avant-garde school;

or (3) Larch Faraji (they/them), lead singer of the third wave neo-old-school punk band DC Trash.

The Bureau of Strange Happenings
An Interactive Phenomenon by Phil Riley
Release 1 / Serial number 230512 / Inform 7 build 6M62 (I6/v6.34 lib 6/12N) SD

Agent Faraji is at the south end of the strip mall parking lot. From here one can see just how humble BOSH's state has become: the office is to the west, between a pawn shop (to the southwest) and a run-down laundromat (to the northwest) and across from an automatic car wash. To the south is a swampy area separating the lot from the interstate. The parking lot continues north.

Their Hyundai is parked nearby.

>x sign
Which do you mean, the department store sign, the laundromat sign or the flashing neon sign?

* * *

>neon
Its flash rate is just a bit over the threshold of irritating.

>x department sign
It's adorned with a pair of angel's wings.

>x pawn shop sign
There's nothing like that nearby.

>sw
Faraji's not that desperate -- yet.

>nw
A sign on the laundromat door says "Closed for renovations".

* * *

>scope
1: Hyperlight (969846)
2: Faraji (973302)
3: a pawn shop door (971894)
4: a laundromat door (971734)
5: an office (971094)
6: Margaret (971606)
7: a department store sign (971638)
8: their Hyundai (971126)
9: an A-plus laundromat (971158)
10: a laundromat sign (971702)
11: a swamp (971190)
12: a Dave's pawn shop (971222)
13: a flashing neon sign (971862)
14: an automatic car wash (971254)
15: an interstate (971286)
16: the Bureau credit card (975606)
17: a green smartphone (975670)

>x hyperlight
There's nothing like that nearby.

>x office
Faraji gazes stoically at the sad little storefront that is the new BOSH office. The sign from the previous tenant is still up: "Angel's Department Store". Through the front window can be seen Margaret, in her usual manic work mode.

>x hq
There's nothing like that nearby.

* * *

>sw
(first opening the pawn shop door)
"Cha-ching!" rings the electronic chime as Faraji steps into the store.

Agent Faraji is in Dave's pawn shop. This is more the seedy, gloomy stereotype of a pawn shop than the glitzy sanitized version of TV reality shows. The blinds in the windows are closed to only allow the barest slant of sunlight in, leaving the sickly fluorescent lights to illuminate the room. There is the distinct smell of cigar smoke. The glass counter is filled with a large collection of possibly valuable items. Behind it is an impressive array of firearms.

A man, presumably Dave, stands behind the main counter eyeing Faraji.

Dave grunts hello.

>ask about pawn shop
(the pawn shop door)
That doesn't seem to be a topic of conversation at the moment.

>ask about dave's pawn shop
That doesn't seem to be a topic of conversation at the moment.

>open pawn shop
That's already open.

>close it
Faraji closes the pawn shop door.

* * *

>hello
Faraji is already talking to Dave.

>goodbye
Faraji says goodbye to Dave.

>hello
(addressing Dave)
Dave grunts hello.

>ask about shop
(Dave)
That doesn't seem to be a topic of conversation at the moment.

>ask about pawn shop
(Dave)
That doesn't seem to be a topic of conversation at the moment.

>x door
It's a typical glass door. The light within is too dim to see much.

* * *

>x owner
He's dressed in polyester, as if he were still wearing last night's bowling shirt. A bit of tattoo peeks out from his open collar.

>ask about the shop
(the pawn shop owner)
That doesn't seem to be a topic of conversation at the moment.

>ask about the pawn shop
(the pawn shop owner)
That doesn't seem to be a topic of conversation at the moment.

>ask about screwdriver
That doesn't seem to be a topic of conversation at the moment.

>actions
Actions listing on.

>ask about screwdriver
[implicit-asking "screwdriver"]
[(1) asking the pawn shop owner about "screwdriver"]
That doesn't seem to be a topic of conversation at the moment.
[(1) asking the pawn shop owner about "screwdriver" - failed the check asking someone about something]

[implicit-asking "screwdriver" - failed the check asking someone about something]

>actions off
Actions listing off.

>trace 4
[Parser tracing set to level 4.]

* * *

>showverbs
[ "showverbs" ? ]
   [NounDomain called at word 1
   seeking definite object
Parse_name called
Pass 1: 0 Pass 2: 0 Pass 3: 0
Parse_name called
Pass 1: 0 Pass 2: 0 Pass 3: 0
Parse_name called
Pass 1: 0 Pass 2: 0 Pass 3: 0
Parse_name called
Pass 1: 0 Pass 2: 0 Pass 3: 0
Parse_name called
Pass 1: 0 Pass 2: 0 Pass 3: 0
Parse_name called
Pass 1: 0 Pass 2: 0 Pass 3: 0
Parse_name called
Pass 1: 0 Pass 2: 0 Pass 3: 0
Parse_name called
Pass 1: 0 Pass 2: 0 Pass 3: 0
Parse_name called
Pass 1: 0 Pass 2: 0 Pass 3: 0
Parse_name called
Pass 1: 0 Pass 2: 0 Pass 3: 0
Parse_name called
Pass 1: 0 Pass 2: 0 Pass 3: 0
Parse_name called
Pass 1: 0 Pass 2: 0 Pass 3: 0
Parse_name called
Pass 1: 0 Pass 2: 0 Pass 3: 0
Parse_name called
Pass 1: 0 Pass 2: 0 Pass 3: 0
Parse_name called
Pass 1: 0 Pass 2: 0 Pass 3: 0
Parse_name called
Pass 1: 0 Pass 2: 0 Pass 3: 0
Parse_name called
Pass 1: 0 Pass 2: 0 Pass 3: 0
Parse_name called
Pass 1: 0 Pass 2: 0 Pass 3: 0
Parse_name called
Pass 1: 0 Pass 2: 0 Pass 3: 0
Parse_name called
Pass 1: 0 Pass 2: 0 Pass 3: 0
Parse_name called
Pass 1: 0 Pass 2: 0 Pass 3: 0
Parse_name called
Pass 1: 0 Pass 2: 0 Pass 3: 0
   [ND made 0 matches]
[Parsing for the verb 'no.verb' (2 lines)]

[line 0 * scope=Routine(540901) -> A95_discussing]
 [line 0 token 1 word 1 : scope=Routine(540901)]
  [Scope routine called at stage 1]
  [Scope routine returned multiple-flag of 0]
  [Object list from word 1]
  [Calling NounDomain on location and actor]
   [NounDomain called at word 1
   seeking definite object
  [Scope routine called at stage 2]
Parse_name called
Pass 1: 0 Pass 2: 0 Pass 3: 0
   [ND made 0 matches]
  [token resulted in failure with error type 18]

[line 1 * creature 'how' 'are' 'you' -> A100_howdeedoing_someone]
[line rejected for not ending with correct preposition]
I'm not sure what you're trying to say. I might just not recognize the words you're using.

>trace off
[ "trace" trace / "off" off ]
[Parsing for the verb 'trace' (4 lines)]

[line 0 * -> TraceOn]
 [line 0 token 1 word 2 : END]

[line 1 * number -> TraceLevel]
 [line 1 token 1 word 2 : number]
  [token resulted in failure with error type 3]

[line 2 * 'on' -> TraceOn]
[line rejected for not ending with correct preposition]

[line 3 * 'off' -> TraceOff]
 [line 3 token 1 word 2 : 'off']
  [token resulted in success]
 [line 3 token 2 word 3 : END]
[Line successfully parsed]
Trace off.

>showverb
Try typing "showverb" and then the name of a verb.

>showverb ask
Verb 'ask' 
     * Routine(587293) scope=Routine(539069) -> A95_discussing
     * 'about' scope=Routine(538516) -> A68_implicit_quizzing
     * 'for' scope=Routine(538688) -> A70_implicit_requesting
     * noun=Routine(538860) Routine(587336) scope=Routine(538897) -> A94_discussing_it_with reverse
     * creature 'for' scope=Routine(538172) -> A62_requesting_it_for
     * creature 'about' scope=Routine(538344) -> A64_quizzing_it_about
     * creature 'about' topic -> Ask
     * creature 'for' topic -> A63_imploring_it_for
     * 'about' topic -> A66_implicit_asking
     * 'for' topic -> A71_implicit_imploring

>t foo
That doesn't seem to be a topic of conversation at the moment.

* * *

>ask about screwdriver
That doesn't seem to be a topic of conversation at the moment.

>ask about dave's
That doesn't seem to be a topic of conversation at the moment.

>hello
Faraji is already talking to the pawn shop owner.

* * *

>z
Faraji stands around and waits.

>x door
There seems to be nothing special about it.

>ne
(first opening the pawn shop door)
Once again -- "Cha-ching!" -- as Faraji leaves the store.

Agent Faraji is at the south end of the strip mall parking lot. From here one can see just how humble BOSH's state has become: the office is to the west, between a pawn shop (to the southwest) and a run-down laundromat (to the northwest) and across from an automatic car wash. To the south is a swampy area separating the lot from the interstate. The parking lot continues north.

Their Hyundai is parked nearby.

The pawn shop door closes.

>nw
(first opening the laundromat door)
(first unlocking the laundromat door)
Faraji lacks a key that fits the laundromat door.

>sw
(first opening the pawn shop door)
Agent Faraji is in Dave's pawn shop. This is more the seedy, gloomy stereotype of a pawn shop than the glitzy sanitized version of TV reality shows. The blinds in the windows are closed to only allow the barest slant of sunlight in, leaving the sickly fluorescent lights to illuminate the room. There is the distinct smell of cigar smoke. The glass counter is filled with a large collection of possibly valuable items. Behind it is an impressive array of firearms.

A man, presumably Dave, stands behind the main counter eyeing Faraji.

Dave grunts hello.

>ne
(first opening the pawn shop door)
Agent Faraji is at the south end of the strip mall parking lot. From here one can see just how humble BOSH's state has become: the office is to the west, between a pawn shop (to the southwest) and a run-down laundromat (to the northwest) and across from an automatic car wash. To the south is a swampy area separating the lot from the interstate. The parking lot continues north.

Their Hyundai is parked nearby.

The pawn shop door closes.

>w
Just like in the store this once was, the door chimes as Faraji walks in.

Agent Faraji is in the front office. It's really a small storefront done up to resemble an office. A store sales counter serves as a front desk, behind which are located shelves of office supplies and a row of drawers. There are also a couch and coffee table here creating a makeshift seating area. An old department store clothing rack serves as a coatrack. Photos on the walls picture the Bureau in better days. A stack of used and empty cardboard boxes sits in one corner.

The Bureau's latest office manager, Margaret is bustling around with unrestrained enthusiasm, unpacking boxes and assembling an approximation of a respectable front office, all as if the Bureau isn't going to be shut down before the year is out. She sees Faraji and practically squeals. "Agent Faraji! I'm sorry -- Larch! How are you? I hope you don't mind -- I took the liberty of putting your desk together. I just love hex wrenches, don't you? Also, your new phone is here. I put it in your desk. Good timing! Now I just need you to give me your old phone so I can deactivate it."

Faraji hands Margaret their old phone. Margaret taps a few keys on her computer and says "There! All settled. Hey, what are you doing for lunch? Let me know when you get hungry!"

Faraji is already talking to Margaret.

A phone is ringing not too far away.

Faraji can ask about the new phone.

>e
Faraji steps out of the office into the parking lot.

Agent Faraji is at the south end of the strip mall parking lot. From here one can see just how humble BOSH's state has become: the office is to the west, between a pawn shop (to the southwest) and a run-down laundromat (to the northwest) and across from an automatic car wash. To the south is a swampy area separating the lot from the interstate. The parking lot continues north.

Their Hyundai is parked nearby.

>w
Agent Faraji is in the front office. It's really a small storefront done up to resemble an office. A store sales counter serves as a front desk, behind which are located shelves of office supplies and a row of drawers. There are also a couch and coffee table here creating a makeshift seating area. An old department store clothing rack serves as a coatrack. Photos on the walls picture the Bureau in better days. A stack of used and empty cardboard boxes sits in one corner.

The Bureau's latest office manager, Margaret is bustling around with unrestrained enthusiasm.

Faraji is already talking to Margaret.

A phone is ringing not too far away.

Faraji can ask about the new phone.

>w
Faraji extricates themself from talking with Margaret.

Agent Faraji is in the hallway. Their office is to the south, Klimp's is to the west, and Moira's is to the north. The front office is east.

A phone is ringing to the south.

* * *

>knock on white door
Faraji gives the white metal door a quick knock, but no one seems to be home.

A phone is ringing inside their desk.

>answer phone
There's nothing like that nearby.

>open desk
(first unlocking Faraji's desk's drawer)
They lack a key that fits their desk's drawer.

A phone is ringing inside their desk.

>e
Faraji can't go that way.

A phone is ringing inside their desk.

* * *

>n
Agent Faraji is in the hallway. Their office is to the south, Klimp's is to the west, and Moira's is to the north. The front office is east.

A phone is ringing to the south.

>n
(first opening Moira's door)
(first unlocking Moira's door)
Faraji lacks a key that fits Moira's door.

A phone is ringing to the south.

>w
(first opening Klimp's door)
(first unlocking Klimp's door)
Faraji lacks a key that fits Klimp's door.

A phone is ringing to the south.

>e
Agent Faraji is in the front office. It's really a small storefront done up to resemble an office. A store sales counter serves as a front desk, behind which are located shelves of office supplies and a row of drawers. There are also a couch and coffee table here creating a makeshift seating area. An old department store clothing rack serves as a coatrack. Photos on the walls picture the Bureau in better days. A stack of used and empty cardboard boxes sits in one corner.

The Bureau's latest office manager, Margaret is bustling around with unrestrained enthusiasm.

Faraji is already talking to Margaret.

A phone is ringing not too far away.

Faraji can ask about the new phone or ask about the status of the computer.

>e
Agent Faraji is at the south end of the strip mall parking lot. From here one can see just how humble BOSH's state has become: the office is to the west, between a pawn shop (to the southwest) and a run-down laundromat (to the northwest) and across from an automatic car wash. To the south is a swampy area separating the lot from the interstate. The parking lot continues north.

Their Hyundai is parked nearby.

* * *

>z
Faraji stands around and waits.

>z
Faraji stands around and waits.

They are already talking to the pawn shop owner.

>restart
Are you sure you want to restart?

>y
Department of Homeland Security, Washington, DC
Open on a drab office with decor dating to the mid-eighties. The DHS assistant to the associate sub-director looks longingly at the office clock nearing five, then leans across the desk and impatiently states his demands:

"First name, last name, pronouns?"

(1) Ezra Gaunt (he/him), winner of the 2006 Baltimore County Edgar Allan Poe Trivia Competition;

(2) Petula Clark Goldberg (she/her), former award-winning dog groomer of the avant-garde school;

or (3) Larch Faraji (they/them), lead singer of the third wave neo-old-school punk band DC Trash.

The Bureau of Strange Happenings
An Interactive Phenomenon by Phil Riley
Release 1 / Serial number 230515 / Inform 7 build 6M62 (I6/v6.34 lib 6/12N) SD

Agent Faraji is at the south end of the strip mall parking lot. From here one can see just how humble BOSH's state has become: the office is to the west, between a pawn shop (to the southwest) and a run-down laundromat (to the northwest) and across from an automatic car wash. To the south is a swampy area separating the lot from the interstate. The parking lot continues north.

Their Hyundai is parked nearby.

>rules
Rules tracing now switched on. Type "rules off" to switch it off again, or "rules all" to include even rules which do not apply.

[Rule "clear LPR rule" applies.]
[Rule "reset skip sounds rule" applies.]

* * *

>taste me
I'm not sure what you're trying to say. I might just not recognize the words you're using.

>n
Faraji trudges to the other end of the parking lot. It's much like where they left.

Agent Faraji is at the north end of the strip mall parking lot. This end is no more auspicious than the other. A convenience store lies to the east. To the west is a military recruitment center. North of here the parking lot exits onto a busy road. There is a rusty sign by the road naming the shopping center: Park Place. South is BOSH headquarters, among other things.

* * *

>e
Faraji is greeted by a blast of music as they enter the store.

Agent Faraji is in the Li'l Nectarine Convenience Store. Li'l Nectarine offers great service and low prices, or so they say. This one's cluttered aisles and sparse shelves could make one wonder if that's true. Behind the counter is the typical array of cigarettes and lottery tickets. Under the counter is a glass case containing various useful items.

The clerk, a scruffy man in his mid-twenties, is leaning against the counter, looking bored.

>ask for a screwdriver
I'm not sure what you're trying to say. I might just not recognize the words you're using.

>x case
In the glass case are a flashlight, a red screwdriver, a laptop computer, some wireless earbuds and a black smart phone.

>ask about screwdriver
I'm not sure what you're trying to say. I might just not recognize the words you're using.

* * *

>test audit-parking-lot-south
(Testing.)

>[1] x bosh
Faraji gazes stoically at the sad little storefront that is the new BOSH office. The sign from the previous tenant is still up: "Angel's Department Store". Through the front window can be seen Margaret, in her usual manic work mode.

>[2] x sign
Which do you mean, the department store sign, the laundromat sign or the flashing neon sign?

>[3] department
It's adorned with a pair of angel's wings.

>[4] x pawn shop
Which do you mean, the pawn shop door or the Dave's pawn shop?

>[5] x neon
Its flash rate is just a bit over the threshold of irritating.

>[6] x margaret
Even from here you can sense Margaret's irrepressible energy.

>[7] x laundromat
Which do you mean, the laundromat door, the A-plus laundromat or the laundromat sign?

>[8] x sign
Which do you mean, the department store sign, the laundromat sign or the flashing neon sign?

>[9] laundromat
It's just a piece of stationery marked up with Sharpie and taped to the door. It says "Closed for renovations".

>[10] x swamp
Swamp Park is, as one might expect, dotted with these little bits of wetland.

>[11] x wetland
Swamp Park is, as one might expect, dotted with these little bits of wetland.

>[12] x interstate
A ways off past the swamp, the highway carries most travelers right past this glum little village.

>[13] x lot
Agent Faraji is at the south end of the strip mall parking lot. From here one can see just how humble BOSH's state has become: the office is to the west, between a pawn shop (to the southwest) and a run-down laundromat (to the northwest) and across from an automatic car wash. To the south is a swampy area separating the lot from the interstate. The parking lot continues north.

Their Hyundai is parked nearby.

>[14] x wash
Much like any other automatic car wash.

>[15] x car
(Faraji's Hyundai)
An old bright red Hyundai Accent, it's been their personal means of transportation for years. And since the Bureau lost its fleet, it's their work car too.

>[16] x hyundai
An old bright red Hyundai Accent, it's been Faraji's personal means of transportation for years. And since the Bureau lost its fleet, it's their work car too.

>[17] enter wash
An automatic car wash isn't of much use when one is on foot.

>[18] e
An automatic car wash isn't of much use when one is on foot.

>[19] x laundromat door
It's a typical glass door. Taped to it is a sign that says "Closed for renovations".

>[20] x pawn shop door
It's a typical glass door. The light within is too dim to see much.

>[21] open laundromat door
It seems to be locked.

>[22] open pawn shop door
Faraji's not that desperate -- yet.

>test audit-parking-lot-north
(Testing.)

>[1] x bosh
Faraji gazes stoically at the sad little storefront that is the new BOSH office. The sign from the previous tenant is still up: "Angel's Department Store". Through the front window can be seen Margaret, in her usual manic work mode.

>[2] x sign
Which do you mean, the department store sign, the laundromat sign or the flashing neon sign?

>[3] department
It's adorned with a pair of angel's wings.

>[4] x pawn shop
Which do you mean, the pawn shop door or the Dave's pawn shop?

>[5] x neon
Its flash rate is just a bit over the threshold of irritating.

>[6] x margaret
Even from here you can sense Margaret's irrepressible energy.

>[7] x laundromat
Which do you mean, the laundromat door, the A-plus laundromat or the laundromat sign?

>[8] x sign
Which do you mean, the department store sign, the laundromat sign or the flashing neon sign?

>[9] laundromat
It's just a piece of stationery marked up with Sharpie and taped to the door. It says "Closed for renovations".

>[10] x swamp
Swamp Park is, as one might expect, dotted with these little bits of wetland.

>[11] x wetland
Swamp Park is, as one might expect, dotted with these little bits of wetland.

>[12] x interstate
A ways off past the swamp, the highway carries most travelers right past this glum little village.

>[13] x lot
Agent Faraji is at the south end of the strip mall parking lot. From here one can see just how humble BOSH's state has become: the office is to the west, between a pawn shop (to the southwest) and a run-down laundromat (to the northwest) and across from an automatic car wash. To the south is a swampy area separating the lot from the interstate. The parking lot continues north.

Their Hyundai is parked nearby.

>[14] x wash
Much like any other automatic car wash.

>[15] x car
(Faraji's Hyundai)
An old bright red Hyundai Accent, it's been their personal means of transportation for years. And since the Bureau lost its fleet, it's their work car too.

>[16] x hyundai
An old bright red Hyundai Accent, it's been Faraji's personal means of transportation for years. And since the Bureau lost its fleet, it's their work car too.

>[17] enter wash
An automatic car wash isn't of much use when one is on foot.

>[18] e
An automatic car wash isn't of much use when one is on foot.

>[19] x laundromat door
It's a typical glass door. Taped to it is a sign that says "Closed for renovations".

>[20] x pawn shop door
It's a typical glass door. The light within is too dim to see much.

>[21] open laundromat door
It seems to be locked.

>[22] open pawn shop door
Faraji's not that desperate -- yet.

* * *

>test lotnorth
(Testing.)

>[1] gonear parking lot north
Agent Faraji is at the north end of the strip mall parking lot. This end is no more auspicious than the other. A convenience store lies to the east. To the west is a military recruitment center. North of here the parking lot exits onto a busy road. There is a rusty sign by the road naming the shopping center: Park Place. South is BOSH headquarters, among other things.

>x lot
Agent Faraji is at the north end of the strip mall parking lot. This end is no more auspicious than the other. A convenience store lies to the east. To the west is a military recruitment center. North of here the parking lot exits onto a busy road. There is a rusty sign by the road naming the shopping center: Park Place. South is BOSH headquarters, among other things.

>x stor
There's nothing like that nearby.

>x store
There's nothing like that nearby.

>x center
There's nothing like that nearby.

>x road
There's nothing like that nearby.

>x sign
There's nothing like that nearby.

>x park place
There's nothing like that nearby.

>x headquarters
There's nothing like that nearby.

>x hq
There's nothing like that nearby.

* * *

>test me
>--> The following tests are available:
'test screwdriver'
'test laundry'
'test closet'
'test audit-parking-lot-south'

>test audit-parking-lot-south
(Testing.)

>[1] x bosh
Faraji gazes stoically at the sad little storefront that is the new BOSH office. The sign from the previous tenant is still up: "Angel's Department Store". Through the front window can be seen Margaret, in her usual manic work mode.

>[2] x sign
Which do you mean, the department store sign, the laundromat sign or the flashing neon sign?

>[3] department
It's adorned with a pair of angel's wings.

>[4] x pawn shop
Which do you mean, the pawn shop door or the Dave's pawn shop?

>[5] x neon
Its flash rate is just a bit over the threshold of irritating.

>[6] x margaret
Even from here you can sense Margaret's irrepressible energy.

>[7] x laundromat
Which do you mean, the laundromat door, the A-plus laundromat or the laundromat sign?

>[8] x sign
Which do you mean, the department store sign, the laundromat sign or the flashing neon sign?

>[9] laundromat
It's just a piece of stationery marked up with Sharpie and taped to the door. It says "Closed for renovations".

>[10] x swamp
Swamp Park is, as one might expect, dotted with these little bits of wetland.

>[11] x wetland
Swamp Park is, as one might expect, dotted with these little bits of wetland.

>[12] x interstate
A ways off past the swamp, the highway carries most travelers right past this glum little village.

>[13] x lot
Agent Faraji is at the south end of the strip mall parking lot. From here one can see just how humble BOSH's state has become: the office is to the west, between a pawn shop (to the southwest) and a run-down laundromat (to the northwest) and across from an automatic car wash. To the south is a swampy area separating the lot from the interstate. The parking lot continues north.

Their Hyundai is parked nearby.

>[14] x wash
Much like any other automatic car wash.

>[15] x car
(Faraji's Hyundai)
An old bright red Hyundai Accent, it's been their personal means of transportation for years. And since the Bureau lost its fleet, it's their work car too.

>[16] x hyundai
An old bright red Hyundai Accent, it's been Faraji's personal means of transportation for years. And since the Bureau lost its fleet, it's their work car too.

>[17] enter wash
An automatic car wash isn't of much use when one is on foot.

>[18] e
An automatic car wash isn't of much use when one is on foot.

>[19] x laundromat door
It's a typical glass door. Taped to it is a sign that says "Closed for renovations".

>[20] x pawn shop door
It's a typical glass door. The light within is too dim to see much.

>[21] open laundromat door
It seems to be locked.

>[22] open pawn shop door
Faraji's not that desperate -- yet.

>x pawn
Which do you mean, the pawn shop door or the Dave's pawn shop?

>door
It's a typical glass door. The light within is too dim to see much.

* * *

>unit
Starting test: x bosh...
Evaluating: x bosh
Assertion failed: produced "Faraji gazes stoically at the sad little storefront that is the new BOSH office. The sign from the previous tenant is still up: "Angel's Department Store". Through the front window can be seen Margaret, in her usual manic work mode.", not "blah"!
Starting test: x sign...
Evaluating: x laundromat sign
Assertion failed: produced "It's just a piece of stationery marked up with Sharpie and taped to the door.", not "foobar"!

Results: 0/2 assertions passed.

>z
Faraji stands around and waits.

Evaluating: laundromat
Assertion failed: produced "I'm not sure what you're trying to say. I might just not recognize the words you're using.", not "foobar"!

Results: 0/2 assertions passed.

>laundromat
I'm not sure what you're trying to say. I might just not recognize the words you're using.

>x sign
Which do you mean, the department store sign, the laundromat sign or the flashing neon sign?

>laundromat
It's just a piece of stationery marked up with Sharpie and taped to the door.

* * *

>x car wash
Much like any other automatic car wash.

>scp[e
I'm not sure what you're trying to say. I might just not recognize the words you're using.

>scope
1: Hyperlight (969846)
2: Faraji (973302)
3: a pawn shop door (971894)
4: a laundromat door (971734)
5: an office (971094)
6: Margaret (971606)
7: a department store sign (971638)
8: their Hyundai (971126)
9: an A-plus laundromat (971158)
10: a laundromat sign (971702)
11: a swamp (971190)
12: a Dave's pawn shop (971222)
13: a flashing neon sign (971862)
14: an automatic car wash (971254)
15: an interstate (971286)
16: the Bureau credit card (975606)
17: a green smartphone (975670)

>x hyperlight
There seems to be nothing special about it.

>x faraji
Agent Faraji

* * *

>x door
Which do you mean, the pawn shop door or the laundromat door?

>pawn
There seems to be nothing special about it.

>x laundromat door
There seems to be nothing special about it.

>sw
(first opening the pawn shop door)
"Cha-ching!" rings the electronic chime as Faraji steps into the store.

Agent Faraji is in Dave's pawn shop. This is more the seedy, gloomy stereotype of a pawn shop than the glitzy sanitized version of TV reality shows. The blinds in the windows are closed to only allow the barest slant of sunlight in, leaving the sickly fluorescent lights to illuminate the room. There is the distinct smell of cigar smoke. The glass counter is filled with a large collection of possibly valuable items. Behind it is an impressive array of firearms.

A man, presumably Dave, stands behind the main counter eyeing Faraji.

Dave grunts hello.

The pawn shop door closes.

>purloin glasses
Which do you mean, to borrow the lenses or the astral lenses?

>astral
Which do you mean, to borrow the lenses or the astral lenses?

>purloin the astral lenses
Which do you mean, to borrow the lenses or the astral lenses?

>purloin the astral lenses
Which do you mean, to borrow the lenses or the astral lenses?

>both
[Purloined.]
[Purloined.]

>wear lenses
Which do you mean, the astral lenses or to borrow the lenses?

>both
Sorry, you can only have one item here. Which exactly?

>astral lenses
Which do you mean, the astral lenses or to borrow the lenses?

>the astral lenses
Which do you mean, the astral lenses or to borrow the lenses?

>showme
Dave's pawn shop - room
    pawn shop door - shop door
    Hyperlight - backdrop
    Faraji - nonbinary
        astral lenses
        to borrow the lenses - quip
        Bureau credit card - money card
        green smartphone - phone
    pawn-light - light source
    Dave - man

* * *

>pawn
There seems to be nothing special about it.

>x pawn
Which do you mean, the pawn shop door or the pawn shop?

>shop
Which do you mean, the pawn shop door or the pawn shop?

>x pawn shop
Which do you mean, the pawn shop door or the pawn shop?

>showme
south end of the strip mall parking lot - room
    Hyperlight - backdrop
    Faraji - nonbinary
        Bureau credit card - money card
        green smartphone - phone
    pawn shop door - closed door
    laundromat door - locked door
    office - unenterable room
        Margaret at a distance (part of office)
        department store sign (part of office)
    their Hyundai
    laundromat - unenterable room
        laundromat sign (part of laundromat)
    swamp - unenterable room
    pawn shop - unenterable room
        flashing neon sign (part of pawn shop)
    automatic car wash - unenterable room
    interstate

* * *

>x margaret
Even from here you can sense her irrepressible energy.

>pronouns
At the moment, "it" means Faraji's Hyundai, "him" is unset, "her" means Margaret, "them" is unset and "me" means Larch Faraji.

>x it
An old bright red Hyundai Accent, it's been Faraji's personal means of transportation for years. And since the Bureau lost its fleet, it's their work car too.

>x her
Even from here you can sense her irrepressible energy.

>x her hyundai
An old bright red Hyundai Accent, it's been Faraji's personal means of transportation for years. And since the Bureau lost its fleet, it's their work car too.

>x their hyundai
An old bright red Hyundai Accent, it's been Faraji's personal means of transportation for years. And since the Bureau lost its fleet, it's their work car too.

>x his hyundai
An old bright red Hyundai Accent, it's been Faraji's personal means of transportation for years. And since the Bureau lost its fleet, it's their work car too.

>x its hyundai
An old bright red Hyundai Accent, it's been Faraji's personal means of transportation for years. And since the Bureau lost its fleet, it's their work car too.

>x our hyundai
There's nothing like that nearby.

>x a hyundai
An old bright red Hyundai Accent, it's been Faraji's personal means of transportation for years. And since the Bureau lost its fleet, it's their work car too.

* * *

>x new
There's nothing like that nearby.

>x new office
Faraji gazes stoically at the sad little storefront that is the new BOSH office. The sign from the previous tenant is still up: "Angel's Department Store". Through the front window can be seen Margaret, in her usual manic work mode.

>x window
There's nothing like that nearby.

>x angel
It's adorned with a pair of angel's wings.

>x storefront
There's nothing like that nearby.

* * *

>x pawn shop
Which do you mean, the door or the pawn shop?

>shop
Which do you mean, the door or the pawn shop?

>l
Agent Faraji is at the south end of the strip mall parking lot. From here one can see just how humble BOSH's state has become: the office is to the west, between a pawn shop (to the southwest) and a run-down laundromat (to the northwest) and across from an automatic car wash. To the south is a swampy area separating the lot from the interstate. The parking lot continues north.

Their Hyundai is parked nearby.

* * *

>x shop
Which do you mean, the pawn shop door or the Dave's pawn shop?

>x pawn shop
Which do you mean, the pawn shop door or the Dave's pawn shop?

>enter pawn shop
Which do you mean, the pawn shop door or the Dave's pawn shop?

>door
(first opening the pawn shop door)
Faraji's not that desperate -- yet.

>showme
south end of the strip mall parking lot - room
    Hyperlight - backdrop
    Faraji - nonbinary
        Bureau credit card - money card
        green smartphone - phone
    pawn shop door - closed door
    laundromat door - locked door
    office - unenterable room
        Margaret at a distance (part of office)
        department store sign (part of office)
    their Hyundai
    laundromat - unenterable room
        laundromat sign (part of laundromat)
    swamp - unenterable room
    Dave's pawn shop - unenterable room
        flashing neon sign (part of Dave's pawn shop)
    automatic car wash - unenterable room
    interstate

>x margaret at a distance
Even from here you can sense her irrepressible energy.

>enter pawn shop
Which do you mean, the pawn shop door or the Dave's pawn shop?

>dave's
Faraji's not that desperate -- yet.

>x shop
Which do you mean, the pawn shop door or the Dave's pawn shop?

>dave's
Faraji observes the pawn shop with obvious distaste. The flashing neon sign in the window advertises "Cash for gold!"

* * *

I beg your pardon?

>l
Agent Faraji is at the south end of the strip mall parking lot. From here one can see just how humble BOSH's state has become: the office is to the west, between a pawn shop (to the southwest) and a run-down laundromat (to the northwest) and across from an automatic car wash. To the south is a swampy area separating the lot from the interstate. The parking lot continues north.

Their Hyundai is parked nearby.

* * *

>x storefront
Faraji gazes stoically at the sad little storefront that is the new BOSH office. The sign from the previous tenant is still up: "Angel's Department Store". Through the front window can be seen Margaret, in her usual manic work mode.

>n
Faraji trudges to the other end of the parking lot. It's much like where they left.

Agent Faraji is at the north end of the strip mall parking lot. This end is no more auspicious than the other. A convenience store lies to the east. To the west is a military recruitment center. North of here the parking lot exits onto a busy road. There is a rusty sign by the road naming the shopping center: Park Place. South is BOSH headquarters, among other things.

>x hq
The BOSH headquarters are to the south.

>x store
It's marked by a sign with a big nectarine on it.

>e
Faraji is greeted by a blast of music as they enter the store.

Agent Faraji is in the Li'l Nectarine Convenience Store. Li'l Nectarine offers great service and low prices, or so they say. This one's cluttered aisles and sparse shelves could make one wonder if that's true. Behind the counter is the typical array of cigarettes and lottery tickets. Under the counter is a glass case containing various useful items.

The clerk, a scruffy man in his mid-twenties, is leaning against the counter, looking bored.

>x aisle
There's nothing like that nearby.

>x aisles
There's nothing like that nearby.

* * *

>x shelves
Faraji hardly needs bread, ketchup, or potato chips.

>x counter
There seems to be nothing special about it.

>x cigarettes
There's nothing like that nearby.

>x tickets
There's nothing like that nearby.

>x counter
There seems to be nothing special about it.

>x case
In the glass case are a flashlight, a red screwdriver, a laptop computer, some wireless earbuds and a black smart phone.

>break glass
Violence isn't the answer to this one.

>restart
Are you sure you want to restart?

>y
Department of Homeland Security, Washington, DC
Open on a drab office with decor dating to the mid-eighties. The DHS assistant to the associate sub-director looks longingly at the office clock nearing five, then leans across the desk and impatiently states his demands:

"First name, last name, pronouns?"

(1) Ezra Gaunt (he/him), winner of the 2006 Baltimore County Edgar Allan Poe Trivia Competition;

(2) Petula Clark Goldberg (she/her), former award-winning dog groomer of the avant-garde school;

or (3) Larch Faraji (they/them), lead singer of the third wave neo-old-school punk band DC Trash.

The Bureau of Strange Happenings
An Interactive Phenomenon by Phil Riley
Release 1 / Serial number 230513 / Inform 7 build 6M62 (I6/v6.34 lib 6/12N) SD

Agent Faraji is at the south end of the strip mall parking lot. From here one can see just how humble BOSH's state has become: the office is to the west, between a pawn shop (to the southwest) and a run-down laundromat (to the northwest) and across from an automatic car wash. To the south is a swampy area separating the lot from the interstate. The parking lot continues north.

Their Hyundai is parked nearby.

>n
Faraji trudges to the other end of the parking lot. It's much like where they left.

Agent Faraji is at the north end of the strip mall parking lot. This end is no more auspicious than the other. A convenience store lies to the east. To the west is a military recruitment center. North of here the parking lot exits onto a busy road. There is a rusty sign by the road naming the shopping center: Park Place. South is BOSH headquarters, among other things.

>x parking lot
Agent Faraji is at the north end of the strip mall parking lot. This end is no more auspicious than the other. A convenience store lies to the east. To the west is a military recruitment center. North of here the parking lot exits onto a busy road. There is a rusty sign by the road naming the shopping center: Park Place. South is BOSH headquarters, among other things.

>x store
It's marked by a sign with a big nectarine on it.

>x center
Patriotic posters paper the windows.

>x road
The main business thoroughfare of Swamp Park.

>x sign
It says "Park Place".

>x park place
Agent Faraji is at the north end of the strip mall parking lot. This end is no more auspicious than the other. A convenience store lies to the east. To the west is a military recruitment center. North of here the parking lot exits onto a busy road. There is a rusty sign by the road naming the shopping center: Park Place. South is BOSH headquarters, among other things.

>n
Faraji has things to do here.

>x postetrs
There's nothing like that nearby.

>x posters
The new slogan is "Answer the Call!"

>x nectarine
It's marked by a sign with a big nectarine on it.

>x park place
Agent Faraji is at the north end of the strip mall parking lot. This end is no more auspicious than the other. A convenience store lies to the east. To the west is a military recruitment center. North of here the parking lot exits onto a busy road. There is a rusty sign by the road naming the shopping center: Park Place. South is BOSH headquarters, among other things.

>x bosh
The BOSH headquarters are to the south.

>w
Faraji will think about joining the military once the Bureau shuts down.

>enter military
Faraji will think about joining the military once the Bureau shuts down.

>center
I'm not sure what you're trying to say. I might just not recognize the words you're using.

>enter store
Faraji is greeted by a blast of music as they enter the store.

Agent Faraji is in the Li'l Nectarine Convenience Store. Li'l Nectarine offers great service and low prices, or so they say. This one's cluttered aisles and sparse shelves could make one wonder if that's true. Behind the counter is the typical array of cigarettes and lottery tickets. Under the counter is a glass case containing various useful items.

The clerk, a scruffy man in his mid-twenties, is leaning against the counter, looking bored.

>out
Faraji exits the store into the relative quiet of the nearby traffic.

Agent Faraji is at the north end of the strip mall parking lot. This end is no more auspicious than the other. A convenience store lies to the east. To the west is a military recruitment center. North of here the parking lot exits onto a busy road. There is a rusty sign by the road naming the shopping center: Park Place. South is BOSH headquarters, among other things.

>e
Faraji is greeted by a blast of music as they enter the store.

Agent Faraji is in the Li'l Nectarine Convenience Store. Li'l Nectarine offers great service and low prices, or so they say. This one's cluttered aisles and sparse shelves could make one wonder if that's true. Behind the counter is the typical array of cigarettes and lottery tickets. Under the counter is a glass case containing various useful items.

The clerk, a scruffy man in his mid-twenties, is leaning against the counter, looking bored.