Department of Homeland Security, Washington, DC
Open on a drab office with decor dating to the mid-eighties. The DHS assistant to the associate sub-director looks longingly at the office clock nearing five, then leans across the desk and impatiently states his demands:

"First name, last name, pronouns?"

(1) Ezra Gaunt (he/him), winner of the 2006 Baltimore County Edgar Allan Poe Trivia Competition;

(2) Petula Clark Goldberg (she/her), former award-winning dog groomer of the avant-garde school;

or (3) Larch Faraji (they/them), lead singer of the third wave neo-old-school punk band DC Trash.

The Bureau of Strange Happenings
An Interactive Phenomenon by Phil Riley
Release 1 / Serial number 231211 / Inform 7 build 6M62 (I6/v6.34 lib 6/12N) SD

Agent Faraji is at the south end of the strip mall parking lot. From here one can see just how humble BOSH's state has become: the office is to the west, between a pawn shop (to the southwest) and a run-down laundromat (to the northwest) and across from an automatic car wash. To the south is a swampy area separating the lot from the interstate. The parking lot continues north.

Their Hyundai is parked nearby.

>gonear closet
(the utility closet)
Agent Faraji is in the dark. 

Some light would be nice.

>lens
Agent Faraji is in the utility closet.

>knock
What do you want to knock?

>door
After a few seconds, someone inserts a key in the lock and opens the door. It's Faraji's colleague Moira Zin. "How'd you get in there, Larch?"

You exit the closet.

Agent Faraji is in Moira's office. 

Also here is Moira Zin.

A phone is ringing somewhere else not too far away.

Wearing the astral lenses in fluorescent light is blinding. Faraji quickly removes the glasses.

Faraji can tell Moira Zin about the hyperdimensional portal or tell Moira Zin to wait for the report.

>x tomes
You can't use multiple objects with that verb.

>x tome
There's nothing like that nearby.

>x tribe
There's nothing like that nearby.

>x tribes
There seems to be nothing special about it.

A phone is ringing somewhere else not too far away.

Faraji can ask to borrow a book, tell Moira Zin about the hyperdimensional portal or tell Moira Zin to wait for the report.

>borrow
A phone is ringing somewhere else not too far away.

Faraji can ask to borrow a book, tell Moira Zin about the hyperdimensional portal or tell Moira Zin to wait for the report.

Moira Zin asks, "What do you want to borrow?"

>borrow
A phone is ringing somewhere else not too far away.

Faraji can ask to borrow a book, tell Moira Zin about the hyperdimensional portal or tell Moira Zin to wait for the report.

Moira Zin asks, "What do you want to borrow?"

>tribes
Faraji takes Tribes of New York.

A phone is ringing somewhere else not too far away.

Faraji can tell Moira Zin about the hyperdimensional portal or tell Moira Zin to wait for the report.

>x tome
There's nothing like that nearby.

>x book
(Tribes of New York)
There seems to be nothing special about it.

A phone is ringing somewhere else not too far away.

Faraji can tell Moira Zin about the hyperdimensional portal or tell Moira Zin to wait for the report.

>x books
On Moira's bookshelves are Applied Speculation, Biking to the Ferry: a Memoir, No Myth After All: A New Perspective on Troy and Twenty Great PhD Theses of the Twentieth Century.

A phone is ringing somewhere else not too far away.

Faraji can tell Moira Zin about the hyperdimensional portal or tell Moira Zin to wait for the report.

>drop book
(Tribes of New York)
Dropped.

A phone is ringing somewhere else not too far away.

Faraji can tell Moira Zin about the hyperdimensional portal or tell Moira Zin to wait for the report.

>take it
That belongs to Moira Zin.

A phone is ringing somewhere else not too far away.

Faraji can tell Moira Zin about the hyperdimensional portal or tell Moira Zin to wait for the report.

* * *

>lens
Agent Faraji is in the utility closet.

>knock door
After a few seconds, someone inserts a key in the lock and opens the door. It's Faraji's colleague Moira Zin. "How'd you get in there, Larch?"

You exit the closet.

Agent Faraji is in Moira's office. 

Also here is Moira Zin.

A phone is ringing somewhere else not too far away.

Wearing the astral lenses in fluorescent light is blinding. Faraji quickly removes the glasses.

Faraji can tell Moira Zin about the hyperdimensional portal or tell Moira Zin to wait for the report.

>x books
On Moira's bookshelves are No Myth After All: A New Perspective on Troy, Twenty Great PhD Theses of the Twentieth Century, Anatomy of a Hoax: Writings on Modern Medicine's Greatest Myths, Tribes of New York, Applied Speculation, Biking to the Ferry: a Memoir, Nonstandard Investigative Techniques, Calculus with Infinitesimals and The Three Stigmata of Palmer Eldritch.

A phone is ringing somewhere else not too far away.

Faraji can ask to borrow a book, tell Moira Zin about the hyperdimensional portal or tell Moira Zin to wait for the report.

>borrow
A phone is ringing somewhere else not too far away.

Faraji can ask to borrow a book, tell Moira Zin about the hyperdimensional portal or tell Moira Zin to wait for the report.

Moira Zin asks, "What do you want to borrow?"

>stigmata
Faraji takes The Three Stigmata of Palmer Eldritch.

A phone is ringing somewhere else not too far away.

Faraji can tell Moira Zin about the hyperdimensional portal or tell Moira Zin to wait for the report.

>tell wait
There's nothing like that nearby.

>tell moira to wait
Faraji says "Strange things are afoot around here, Agent Zin."

"Do tell," says Moira Zin.

"After I talk to Klimp."

A phone is ringing somewhere else not too far away.

* * *

>x books
On Moira's bookshelves are No Myth After All: A New Perspective on Troy, Twenty Great PhD Theses of the Twentieth Century, Anatomy of a Hoax: Writings on Modern Medicine's Greatest Myths, Tribes of New York, Applied Speculation, Biking to the Ferry: a Memoir, Nonstandard Investigative Techniques, Calculus with Infinitesimals and The Three Stigmata of Palmer Eldritch.

A phone is ringing somewhere else not too far away.

Faraji can ask to borrow a book, tell Moira Zin about the hyperdimensional portal or tell Moira Zin to wait for the report.

>x book
Which do you mean, Tribes of New York, Applied Speculation, Biking to the Ferry: a Memoir, No Myth After All: A New Perspective on Troy or Twenty Great PhD Theses of the Twentieth Century?

>theses
There seems to be nothing special about it.

A phone is ringing somewhere else not too far away.

Faraji can ask to borrow a book, tell Moira Zin about the hyperdimensional portal or tell Moira Zin to wait for the report.

>borrow
A phone is ringing somewhere else not too far away.

Faraji can ask to borrow a book, tell Moira Zin about the hyperdimensional portal or tell Moira Zin to wait for the report.

Moira Zin asks, "What do you want to borrow?"

>theses
Faraji takes Twenty Great PhD Theses of the Twentieth Century.

A phone is ringing somewhere else not too far away.

Faraji can tell Moira Zin about the hyperdimensional portal or tell Moira Zin to wait for the report.

>drop it
Dropped.

A phone is ringing somewhere else not too far away.

Faraji can tell Moira Zin about the hyperdimensional portal or tell Moira Zin to wait for the report.

>take it
Taken.

A phone is ringing somewhere else not too far away.

Faraji can tell Moira Zin about the hyperdimensional portal or tell Moira Zin to wait for the report.

>give it to moira
Moira smiles. "Thanks for getting it back to me." She puts the book back on the shelf.

A phone is ringing somewhere else not too far away.

Faraji can ask to borrow a book, tell Moira Zin about the hyperdimensional portal or tell Moira Zin to wait for the report.

* * *

>gonear field office
Which do you mean, field office area, field office reception, the field office hallway or the field office chief's office?

>gonear field office reception
Agent Faraji is at field office reception. Hooray you made it!

Also here is Maggie.

>w
Agent Faraji is in the field office hallway. Hallway

>x
(the green smartphone)
It's a pretty nice phone, only a couple of years old, but Faraji doesn't have time to play with it. They need to get to the office.

>s
Agent Faraji is in Christy's office. 

Also here is Christy.

>n
Agent Faraji is in the field office hallway. Hallway

>n
Agent Faraji is in Minerva's office. 

Also here is Minerva.

>s
Agent Faraji is in the field office hallway. Hallway

>l
Agent Faraji is in the field office hallway. Hallway

>w
Agent Faraji is in the field office chief's office. Doris's office

Doris is sitting cross-legged in a chair, tapping his foot lazily on the desk.

"Ah, Larch," Doris exclaims, standing up to shake their hand. "I've been waiting for you to pay us a visit. Did you bring the thumb drive?"

Faraji can ask who he is, ask where we are, ask how to get home or ask what thumb drive.

* * *

>what thumb drive
Faraji looks quizzical. "What thumb drive?"

"Huh. Thought you would have found it by now. I'm almost certain it's in your Swamp Park office. Go find it and bring it here." Doris busies himself at his desk, pointedly ignoring you.

Faraji can ask who he is, ask where we are or ask how to get home.

>how to get home
Faraji asks, "Just how can I get home from here?"

"Go ask Maggie; she can help you."

Faraji can ask who he is or ask where we are.

>e
Agent Faraji is in the field office hallway. Hallway

>s
Agent Faraji is in Christy's office. 

Also here is Christy.

* * *

>n
Agent Faraji is in the field office hallway. Hallway

>f
Agent Faraji is in Portal Room 1. 

Also here is a portal to the past.

>b
Agent Faraji is in the field office hallway. Hallway

>b
Agent Faraji is in Portal Room 2.

>enter portal
There's nothing like that nearby.

>gonear closet
(the utility closet)
Agent Faraji is in the dark. 

Some light would be nice.

>knock
(the green smartphone)
Faraji gives the green smartphone a quick knock, but nothing happens.

>knock on door
There's nothing like that nearby.

>lens
Agent Faraji is in the utility closet.

>open door
It seems to be locked.

>knock on door
After a few seconds, someone inserts a key in the lock and opens the door. It's Faraji's colleague Moira Zin. "How'd you get in there, Larch?"

You exit the closet.

Agent Faraji is in Moira's office. 

Also here is Moira Zin.

A phone is ringing somewhere else not too far away.

Wearing the astral lenses in fluorescent light is blinding. Faraji quickly removes the glasses.

Faraji can tell Moira Zin about the hyperdimensional portal or tell Moira Zin to wait for the report.

>tell zin about the portal
Faraji scratches their head. "Um, I was transported there through an hyperdimensional portal. How's your morning been?"

Moira Zin raises an eyebrow. "Well, I suggest you let the Chief know."

A phone is ringing somewhere else not too far away.

>x books
On Moira's bookshelves are Tribes of New York, Applied Speculation, Biking to the Ferry: a Memoir, No Myth After All: A New Perspective on Troy and Twenty Great PhD Theses of the Twentieth Century.

A phone is ringing somewhere else not too far away.

I beg your pardon?

>l
Agent Faraji is in Moira's office. 

Also here is Moira Zin.

A phone is ringing somewhere else not too far away.

>ask to borrow a book
I'm not sure what you're trying to say. I might just not recognize the words you're using.

>x tribes
There seems to be nothing special about it.

A phone is ringing somewhere else not too far away.

Faraji can ask to borrow Tribes of New York.

* * *

>x books
On Moira's bookshelves are Tribes of New York, Applied Speculation, Biking to the Ferry: a Memoir, No Myth After All: A New Perspective on Troy and Twenty Great PhD Theses of the Twentieth Century.

A phone is ringing somewhere else not too far away.

>take biking to the ferry: a memoir
I only understood you as far as wanting to take Biking to the Ferry: a Memoir.

>take biking to the ferry a memoir
Taken.

A phone is ringing somewhere else not too far away.

>s
(first opening Moira's door)
Agent Faraji is in the hallway. Their office is to the south, Klimp's is to the west, and Moira's is to the north. The front office is east.

A phone is ringing to the south.

>w
(first opening Klimp's door)
It seems to be locked.

A phone is ringing to the south.

>e
Agent Faraji is in the front office. It's really a small storefront done up to resemble an office. A store sales counter serves as a front desk, behind which are located shelves of office supplies and a row of drawers. There are also a couch and coffee table here creating a makeshift seating area. An old department store clothing rack serves as a coatrack. Photos on the walls picture the Bureau in better days. A stack of used and empty cardboard boxes sits in one corner.

The Bureau's latest office manager, Margaret is bustling around with unrestrained enthusiasm, unpacking boxes and assembling an approximation of a respectable front office, all as if the Bureau isn't going to be shut down before the year is out. She sees Faraji and practically squeals. "Agent Faraji! I'm sorry -- Larch! How are you? I hope you don't mind -- I took the liberty of putting your desk together. I just love hex wrenches, don't you? Also, your new phone is here. I put it in your desk. Now I just need you to give me your old phone so I can deactivate it."

Faraji hands Margaret their old phone. Margaret taps a few keys on her computer and says "There! All settled."

"Oh, good", Faraji says. "Our phone downgrades have arrived from our bureaucratic betters."

A phone is ringing somewhere else not too far away.

Faraji can ask about the phone exchange.

>purloin button
[Purloined.]

>press button
The world turns inside out, and suddenly Faraji is somewhere else.

Agent Faraji is in the field office chief's office. Doris's office

Doris is sitting cross-legged in a chair, tapping his foot lazily on the desk.

Faraji can ask about the phone exchange.

>w
Faraji can't go that way.

Faraji can ask about the phone exchange.

>e
Agent Faraji is in the field office hallway. Hallway

Faraji can ask about the phone exchange.

>w
Agent Faraji is in the field office chief's office. Doris's office

Doris is sitting cross-legged in a chair, tapping his foot lazily on the desk.

Faraji can ask about the phone exchange.

>e
Agent Faraji is in the field office hallway. Hallway

Faraji can ask about the phone exchange.

* * *

>w
Agent Faraji is in the field office chief's office. Doris's office

Doris is sitting cross-legged in a chair, tapping his foot lazily on the desk.

Faraji can ask about the phone exchange.

>s
Faraji can't go that way.

Faraji can ask about the phone exchange.

>ask about the phone
Faraji asks, "Tell me what's going on with the phones again?"

Margaret looks apologetic. "I'm sorry, I thought everyone knew. Budget cuts. They're trading in all our smart phones for cheaper models."

>e
Agent Faraji is in the field office hallway. Hallway

>e
Agent Faraji is at field office reception. Hooray you made it!

Also here is Maggie.

>gonear moira
Agent Faraji is in Moira's office. 

Also here is Moira Zin.

A phone is ringing somewhere else not too far away.

>x moira
Agent Moira Zin is the very model of a competent Bureau agent. Hard-working, serious, no-nonsense but open-minded, she's the sober counter-balance to Klimp's sometimes childish credulity. Moira would clearly be a rising star if it weren't for the Bureau's pending dissolution.

A phone is ringing somewhere else not too far away.

>x shelves
FILL THIS IN

On Moira's bookshelves are Tribes of New York, Applied Speculation and No Myth After All: A New Perspective on Troy.

A phone is ringing somewhere else not too far away.

* * *

>x books
On Moira's bookshelves are Tribes of New York, Applied Speculation, Biking to the Ferry: a Memoir, No Myth After All: A New Perspective on Troy and Twenty Great PhD Theses of the Twentieth Century.

A phone is ringing somewhere else not too far away.

>take memoir
Taken.

A phone is ringing somewhere else not too far away.

>i
Faraji is carrying:
  Biking to the Ferry, a Memoir
  a pair of astral lenses
  a green smartphone

A phone is ringing somewhere else not too far away.

>read it
There seems to be nothing special about it.

A phone is ringing somewhere else not too far away.

>take all
There is nothing there.

>take all
There is nothing there.

>take all from shelf
There's nothing like that nearby.

>take all from bookshelves
Tribes of New York: Taken.
Applied Speculation: Taken.
No Myth After All: A New Perspective on Troy: Taken.

A phone is ringing somewhere else not too far away.

* * *

>take memoir
Taken.

A phone is ringing somewhere else not too far away.

>take tribes
That belongs to Moira Zin.

A phone is ringing somewhere else not too far away.

* * *

>x books
On Moira's bookshelves are Tribes of New York, Applied Speculation, Biking to the Ferry: a Memoir, No Myth After All: A New Perspective on Troy and Twenty Great PhD Theses of the Twentieth Century.

A phone is ringing somewhere else not too far away.

>x tribes
There seems to be nothing special about it.

A phone is ringing somewhere else not too far away.

Faraji can ask to borrow a book.

>actions
Actions listing on.

>ask to borrow a book
[discussing to borrow a book]

[discussing to borrow a book - succeeded]

A phone is ringing somewhere else not too far away.

Faraji can ask to borrow Tribes of New York.

Moira Zin asks, "What do you want to borrow?"

>biking
[supplying an answer with Biking to the Ferry: a Memoir]
[supplying an answer with Biking to the Ferry: a Memoir - succeeded]

A phone is ringing somewhere else not too far away.

Faraji can ask to borrow Tribes of New York.

* * *

>x tribes
There seems to be nothing special about it.

A phone is ringing somewhere else not too far away.

Faraji can ask to borrow a book.

>ask to book
Which do you mean, to borrow a book or to borrow Tribes of New York?

>borrow a book
A phone is ringing somewhere else not too far away.

Faraji can ask to borrow Tribes of New York.

Moira Zin asks, "What do you want to borrow?"

>l
Agent Faraji is in Moira's office. 

Also here is Moira Zin.

A phone is ringing somewhere else not too far away.

Faraji can ask to borrow Tribes of New York.

Moira Zin asks, "What do you want to borrow?"

* * *

>x tribes
There seems to be nothing special about it.

A phone is ringing somewhere else not too far away.

Faraji can ask to borrow a book.

>ask to borrow
A phone is ringing somewhere else not too far away.

Faraji can ask to borrow a book.

Moira Zin asks, "What do you want to borrow?"

>borrow a book
A phone is ringing somewhere else not too far away.

Faraji can ask to borrow a book.

Moira Zin asks, "What do you want to borrow?"

>zin
boo
A phone is ringing somewhere else not too far away.

Faraji can ask to borrow a book.

* * *

>ask to borrow
A phone is ringing somewhere else not too far away.

Faraji can ask to borrow a book.

Moira Zin asks, "What do you want to borrow?"

>look
Agent Faraji is in Moira's office. 

Also here is Moira Zin.

A phone is ringing somewhere else not too far away.

>ask to borrow
I'm not sure what you're trying to say. I might just not recognize the words you're using.

* * *

>ask to borrow
A phone is ringing somewhere else not too far away.

Faraji can ask to borrow a book.

Moira Zin asks, "What do you want to borrow?"

>x new york
There seems to be nothing special about it.

A phone is ringing somewhere else not too far away.

* * *

>x tribes
There seems to be nothing special about it.

A phone is ringing somewhere else not too far away.

Faraji can ask to borrow a book.

>ask to borrow a book
A phone is ringing somewhere else not too far away.

Faraji can ask to borrow a book.

Moira Zin asks, "What do you want to borrow?"

>applied
supplied: Applied Speculation.

A phone is ringing somewhere else not too far away.

Faraji can ask to borrow Tribes of New York.

>asdfasdf
I'm not sure what you're trying to say. I might just not recognize the words you're using.

>ask to borrow a book
There's nothing like that nearby.

* * *

>ask to borrow a book
A phone is ringing somewhere else not too far away.

Faraji can ask to borrow a book.

Moira Zin asks, "What do you want to borrow?"

>applied speculation
Faraji takes Applied Speculation.

A phone is ringing somewhere else not too far away.

>ask to borrow
A phone is ringing somewhere else not too far away.

Moira Zin asks, "What do you want to borrow?"

>l
Agent Faraji is in Moira's office. 

Also here is Moira Zin.

A phone is ringing somewhere else not too far away.

>i
Faraji is carrying:
  Applied Speculation
  a pair of astral lenses
  a green smartphone

A phone is ringing somewhere else not too far away.

>put applied on shelf
A phone is ringing somewhere else not too far away.

Faraji can ask to borrow a book.

>i
Faraji is carrying:
  a pair of astral lenses
  a green smartphone

A phone is ringing somewhere else not too far away.

>l
Agent Faraji is in Moira's office. 

Also here is Moira Zin.

A phone is ringing somewhere else not too far away.

* * *

>applied speculation
Faraji takes Applied Speculation.

A phone is ringing somewhere else not too far away.

>borrow
Moira shakes her head. "Sorry, I'll only lend one book at a time."

A phone is ringing somewhere else not too far away.

>give book to moira
There's nothing like that nearby.

>give applied speculation to moira
A phone is ringing somewhere else not too far away.

Faraji can ask to borrow a book.

* * *

>borrow
Moira shakes her head. "Sorry, I'll only lend one book at a time."

A phone is ringing somewhere else not too far away.

>give it to moira
Faraji can't see 'it' (nothing) at the moment.

>actions
Actions listing on.

>give applied to moira
[giving Applied Speculation to Moira Zin]
That doesn't seem to be a topic of conversation at the moment.
[giving Applied Speculation to Moira Zin - succeeded]

A phone is ringing somewhere else not too far away.

Faraji can ask to borrow a book.

>undo
Moira's office
[Previous turn undone.]

>rules
Rules tracing now switched on. Type "rules off" to switch it off again, or "rules all" to include even rules which do not apply.

[Rule "clear LPR rule" applies.]
[Rule "reset skip sounds rule" applies.]

* * *

>give it to moira
Faraji can't see 'it' (nothing) at the moment.

>give applied to moira
Moira smiles. "Thanks for getting it back to me." She puts the book back on the shelf.

A phone is ringing somewhere else not too far away.

Faraji can ask to borrow a book.

>borrow
A phone is ringing somewhere else not too far away.

Faraji can ask to borrow a book.

Moira Zin asks, "What do you want to borrow?"

>bikers
I'm not sure what you're trying to say. I might just not recognize the words you're using.

Moira Zin asks, "What do you want to borrow?"

>l
Agent Faraji is in Moira's office. 

Also here is Moira Zin.

A phone is ringing somewhere else not too far away.

Faraji can ask to borrow a book.

>s
(first opening Moira's door)
Agent Faraji is in the hallway. Their office is to the south, Klimp's is to the west, and Moira's is to the north. The front office is east.

A phone is ringing to the south.

>e
Agent Faraji is in the front office. It's really a small storefront done up to resemble an office. A store sales counter serves as a front desk, behind which are located shelves of office supplies and a row of drawers. There are also a couch and coffee table here creating a makeshift seating area. An old department store clothing rack serves as a coatrack. Photos on the walls picture the Bureau in better days. A stack of used and empty cardboard boxes sits in one corner.

The Bureau's latest office manager, Margaret is bustling around with unrestrained enthusiasm, unpacking boxes and assembling an approximation of a respectable front office, all as if the Bureau isn't going to be shut down before the year is out. She sees Faraji and practically squeals. "Agent Faraji! I'm sorry -- Larch! How are you? I hope you don't mind -- I took the liberty of putting your desk together. I just love hex wrenches, don't you? Also, your new phone is here. I put it in your desk. Now I just need you to give me your old phone so I can deactivate it."

Faraji hands Margaret their old phone. Margaret taps a few keys on her computer and says "There! All settled."

"Oh, good", Faraji says. "Our phone downgrades have arrived from our bureaucratic betters."

A phone is ringing somewhere else not too far away.

Faraji can ask about the phone exchange.

>w
Faraji extricates themself from talking with Margaret.

Agent Faraji is in the hallway. Their office is to the south, Klimp's is to the west, and Moira's is to the north. The front office is east.

A phone is ringing to the south.

>n
Agent Faraji is in Moira's office. 

Also here is Moira Zin.

A phone is ringing somewhere else not too far away.

Faraji can ask to borrow a book.

* * *

>give applied to moira
Moira smiles. "Thanks for getting it back to me." She puts the book back on the shelf.

A phone is ringing somewhere else not too far away.

Faraji can ask to borrow a book.

>i
Faraji is carrying:
  a pair of astral lenses
  a green smartphone

A phone is ringing somewhere else not too far away.

Faraji can ask to borrow a book.

* * *

>applied speculation
Faraji takes Applied Speculation.

A phone is ringing somewhere else not too far away.

>undo
Moira's office
[Previous turn undone.]

Moira Zin asks, "What do you want to borrow?"

>biking to the ferry
A phone is ringing somewhere else not too far away.

Faraji can ask to borrow Tribes of New York.

* * *

>ask to borrow a book
A phone is ringing somewhere else not too far away.

Faraji can ask to borrow a book.

Moira Zin asks, "What do you want to borrow?"

>asdf
I'm not sure what you're trying to say. I might just not recognize the words you're using.

Moira Zin asks, "What do you want to borrow?"

>Tribes
Faraji asks, "I've always wanted to read Tribes of New York. Mind if I borrow it?"

"Okay, but be gentle with it."

They take Tribes of New York.

A phone is ringing somewhere else not too far away.

What do you want to borrow

>tribe
I'm not sure what you're trying to say. I might just not recognize the words you're using.

What do you want to borrow

>perspective
supplied: No Myth After All: A New Perspective on Troy.

A phone is ringing somewhere else not too far away.

What do you want to borrow

* * *

>asdf
I'm not sure what you're trying to say. I might just not recognize the words you're using.

Moira Zin asks, "What do you want to borrow?"

>biking
boowoot
A phone is ringing somewhere else not too far away.

Faraji can ask to borrow Tribes of New York.

* * *

>asdf
I'm not sure what you're trying to say. I might just not recognize the words you're using.

Moira Zin asks, "What do you want to borrow?"

>tribes
Faraji asks, "I've always wanted to read Tribes of New York. Mind if I borrow it?"

"Okay, but be gentle with it."

They take Tribes of New York.

A phone is ringing somewhere else not too far away.

Moira Zin asks, "What do you want to borrow?"

>l
Agent Faraji is in Moira's office. 

Also here is Moira Zin.

A phone is ringing somewhere else not too far away.

Moira Zin asks, "What do you want to borrow?"

* * *

>ask to borrow a book
A phone is ringing somewhere else not too far away.

Faraji can ask to borrow a book.

Moira Zin asks, "What do you want to borrow?"

>asdfa
I'm not sure what you're trying to say. I might just not recognize the words you're using.

Moira Zin asks, "What do you want to borrow?"

>tribes
Faraji asks, "I've always wanted to read Tribes of New York. Mind if I borrow it?"

"Okay, but be gentle with it."

They take Tribes of New York.

A phone is ringing somewhere else not too far away.

Moira Zin asks, "What do you want to borrow?"

>perspective
I'm not sure what you're trying to say. I might just not recognize the words you're using.

Moira Zin asks, "What do you want to borrow?"

>biking to the ferry
I'm not sure what you're trying to say. I might just not recognize the words you're using.

Moira Zin asks, "What do you want to borrow?"

* * *

>ask to borrow a book
A phone is ringing somewhere else not too far away.

Faraji can ask to borrow a book.

Moira Zin asks, "What do you want to borrow?"

>biking
Faraji takes Biking to the Ferry: a Memoir.

A phone is ringing somewhere else not too far away.

>undo
Moira's office
[Previous turn undone.]

Moira Zin asks, "What do you want to borrow?"

>actions
Actions listing on.

>biking
I'm not sure what you're trying to say. I might just not recognize the words you're using.

>restart
[restarting the game]
Are you sure you want to restart?

>n
[restarting the game - succeeded]

* * *

>ask to borrow a book
A phone is ringing somewhere else not too far away.

Faraji can ask to borrow a book.

Moira Zin asks, "What do you want to borrow?"

>tribes
Faraji asks, "I've always wanted to read Tribes of New York. Mind if I borrow it?"

"Okay, but be gentle with it."

They take Tribes of New York.

A phone is ringing somewhere else not too far away.

* * *

>ask to borrow a book
A phone is ringing somewhere else not too far away.

Faraji can ask to borrow a book.

Moira Zin asks, "What do you want to borrow?"

>zin
Faraji can't borrow that.

A phone is ringing somewhere else not too far away.

Faraji can ask to borrow a book.

>undo
Moira's office
[Previous turn undone.]

Moira Zin asks, "What do you want to borrow?"

>l
Agent Faraji is in Moira's office. 

Also here is Moira Zin.

A phone is ringing somewhere else not too far away.

Faraji can ask to borrow a book.

>ask to borrow a book
A phone is ringing somewhere else not too far away.

Faraji can ask to borrow a book.

Moira Zin asks, "What do you want to borrow?"

>book
A phone is ringing somewhere else not too far away.

Faraji can ask to borrow a book.

Moira Zin asks, "What do you want to borrow?"

>i
Faraji is carrying:
  a pair of astral lenses
  a green smartphone

A phone is ringing somewhere else not too far away.

Faraji can ask to borrow a book.

>ask to borrow a book
A phone is ringing somewhere else not too far away.

Faraji can ask to borrow a book.

Moira Zin asks, "What do you want to borrow?"

>twenty
Faraji takes Twenty Great PhD Theses of the Twentieth Century
A phone is ringing somewhere else not too far away.

Faraji can ask to borrow a book.

* * *

>x tribes
There seems to be nothing special about it.

A phone is ringing somewhere else not too far away.

Faraji can ask to borrow a book.

>ask to borrow book
Which do you mean, to borrow a book or to borrow Tribes of New York?

>ask to borrow a book
A phone is ringing somewhere else not too far away.

Faraji can ask to borrow Tribes of New York.

Moira Zin asks, "What do you want to borrow?"

>asdf
I'm not sure what you're trying to say. I might just not recognize the words you're using.

Moira Zin asks, "What do you want to borrow?"

>l
Agent Faraji is in Moira's office. 

Also here is Moira Zin.

A phone is ringing somewhere else not too far away.

Faraji can ask to borrow Tribes of New York.

Moira Zin asks, "What do you want to borrow?"

>rules
Rules tracing now switched on. Type "rules off" to switch it off again, or "rules all" to include even rules which do not apply.

[Rule "clear LPR rule" applies.]
[Rule "reset skip sounds rule" applies.]
Moira Zin asks, "What do you want to borrow?"

* * *

>tell zin about the portal
Faraji scratches their head. "Um, I was transported there through an hyperdimensional portal. How's your morning been?"

Moira Zin raises an eyebrow. "Well, I suggest you let the Chief know."

A phone is ringing somewhere else not too far away.

>x desk
It's a pretty ordinary mass-produced desk, but Moira's re-stain job on it has truly transformed it. Really, is there anything she can't do?

A phone is ringing somewhere else not too far away.

>x shelves
FILL THIS IN

On Moira's bookshelves are Tribes of New York, Applied Speculation, Biking to the Ferry, a Memoir and No Myth After All: A New Perspective on Troy.

A phone is ringing somewhere else not too far away.

>x shelf
There's nothing like that nearby.

>x books
FILL THIS IN

On Moira's bookshelves are Tribes of New York, Applied Speculation, Biking to the Ferry, a Memoir and No Myth After All: A New Perspective on Troy.

A phone is ringing somewhere else not too far away.

>open desk
It isn't something Faraji can open.

A phone is ringing somewhere else not too far away.

>open drawer
That's already open.

A phone is ringing somewhere else not too far away.

>x drawer
Moira's drawer is empty.

A phone is ringing somewhere else not too far away.

* * *

>gonear moira's office
Agent Faraji is in Moira's office.

>look
Agent Faraji is in Moira's office.

>x shelves
On Moira's bookshelves are No Myth After All: A New Perspective on Troy, Twenty Great PhD Theses of the Twentieth Century, Anatomy of a Hoax: Writings on Modern Medicine's Greatest Myths, Tribes of New York, Applied Speculation, Biking to the Ferry: a Memoir, Nonstandard Investigative Techniques, Calculus with Infinitesimals and The Three Stigmata of Palmer Eldritch.

>take no myth
That belongs to Moira Zin.

>gonear moira
Agent Faraji is in the Room of Stuff. 

Also here are Moira Zin, Chief Klimp, Faraji's former self, a thumb drive, a blue screwdriver, Ezra Gaunt, Petula Goldberg, a the good old days, Senator Savra, finding the drive, some flattened boxes and some flattened boxes.

>z
Faraji stands around and waits.

>l
Agent Faraji is in the Room of Stuff. 

Also here are Moira Zin, Chief Klimp, Faraji's former self, a thumb drive, a blue screwdriver, Ezra Gaunt, Petula Goldberg, a the good old days, Senator Savra, finding the drive, some flattened boxes and some flattened boxes.

>x moira
Agent Moira Zin is the very model of a competent Bureau agent. Hard-working, serious, no-nonsense but open-minded, she's the sober counter-balance to Klimp's sometimes childish credulity. Moira would clearly be a rising star if it weren't for the Bureau's pending dissolution.

>borrow
I'm not sure what you're trying to say. I might just not recognize the words you're using.

* * *

>hyundai
I'm not sure what you're trying to say. I might just not recognize the words you're using.

>verbs
I'm not sure what you're trying to say. I might just not recognize the words you're using.

* * *

>i
Faraji is carrying:
  a green smartphone

>w
Just like in the store this once was, the door chimes as Faraji walks in.

Agent Faraji is in the front office. It's really a small storefront done up to resemble an office. A store sales counter serves as a front desk, behind which are located shelves of office supplies and a row of drawers. There are also a couch and coffee table here creating a makeshift seating area. An old department store clothing rack serves as a coatrack. Photos on the walls picture the Bureau in better days. A stack of used and empty cardboard boxes sits in one corner.

The Bureau's latest office manager, Margaret is bustling around with unrestrained enthusiasm, unpacking boxes and assembling an approximation of a respectable front office, all as if the Bureau isn't going to be shut down before the year is out. She sees Faraji and practically squeals. "Agent Faraji! I'm sorry -- Larch! How are you? I hope you don't mind -- I took the liberty of putting your desk together. I just love hex wrenches, don't you? Also, your new phone is here. I put it in your desk. Now I just need you to give me your old phone so I can deactivate it."

Faraji hands Margaret their old phone. Margaret taps a few keys on her computer and says "There! All settled."

"Oh, good", Faraji says. "Our phone downgrades have arrived from our bureaucratic betters."

A phone is ringing somewhere else not too far away.

Faraji can ask about the phone exchange.

>take all
There is nothing there.

>look behind desk
There are a number of shelves of office supplies behind the desk. There is also a heating vent on the floor here.

Faraji finds their computer and pulls it out.

A phone is ringing somewhere else not too far away.

Faraji can ask about the phone exchange.

>take computer
Taken.

A phone is ringing somewhere else not too far away.

Faraji can ask about the phone exchange.

>i
Faraji is carrying:
  their computer

A phone is ringing somewhere else not too far away.

Faraji can ask about the phone exchange.

>x computer
Faraji's computer has been damaged beyond repair. But they do find a thumb drive and take it.

A phone is ringing somewhere else not too far away.

Faraji can remember finding the drive. They can ask about the phone exchange.

>i
Faraji is carrying:
  a thumb drive
  their computer

A phone is ringing somewhere else not too far away.

Faraji can ask about the phone exchange.

>take box
Faraji picks up a couple of boxes and flattens them.

Margaret says, "Hey, what are you doing with those boxes, Agent Faraji? You don't have to worry about that -- I'll get them." She takes the flattened boxes from Faraji and hustles off.

A phone is ringing somewhere else not too far away.

Margaret goes west.

>take box
Faraji picks up a couple of boxes and flattens them.

A phone is ringing somewhere else not too far away.

>i
Faraji is carrying:
  some flattened boxes
  a thumb drive
  their computer

A phone is ringing somewhere else not too far away.

>drop box
Faraji doesn't have that.

A phone is ringing somewhere else not too far away.

>take it
Faraji already has that.

A phone is ringing somewhere else not too far away.

>drop boxes
(the flattened boxes)
Dropped.

A phone is ringing somewhere else not too far away.

>take boxes
(the flattened boxes)
Taken.

A phone is ringing somewhere else not too far away.

>i
Faraji is carrying:
  some flattened boxes
  a thumb drive
  their computer

A phone is ringing somewhere else not too far away.

* * *

>rules
Rules tracing now switched on. Type "rules off" to switch it off again, or "rules all" to include even rules which do not apply.

[Rule "clear LPR rule" applies.]
[Rule "reset skip sounds rule" applies.]

>asd
[Rule "After reading a command" applies.]
I'm not sure what you're trying to say. I might just not recognize the words you're using.
[Rule "clear LPR rule" applies.]
[Rule "reset skip sounds rule" applies.]

* * *

>w
Just like in the store this once was, the door chimes as Faraji walks in.

Agent Faraji is in the front office. It's really a small storefront done up to resemble an office. A store sales counter serves as a front desk, behind which are located shelves of office supplies and a row of drawers. There are also a couch and coffee table here creating a makeshift seating area. An old department store clothing rack serves as a coatrack. Photos on the walls picture the Bureau in better days. A stack of used and empty cardboard boxes sits in one corner.

The Bureau's latest office manager, Margaret is bustling around with unrestrained enthusiasm, unpacking boxes and assembling an approximation of a respectable front office, all as if the Bureau isn't going to be shut down before the year is out. She sees Faraji and practically squeals. "Agent Faraji! I'm sorry -- Larch! How are you? I hope you don't mind -- I took the liberty of putting your desk together. I just love hex wrenches, don't you? Also, your new phone is here. I put it in your desk. Now I just need you to give me your old phone so I can deactivate it."

Faraji hands Margaret their old phone. Margaret taps a few keys on her computer and says "There! All settled."

"Oh, good", Faraji says. "Our phone downgrades have arrived from our bureaucratic betters."

A phone is ringing somewhere else not too far away.

Faraji can ask about the phone exchange.

>gonear closet
(the utility closet)
Agent Faraji is in the dark. 

Some light would be nice.

Faraji can ask about the phone exchange.

>lens
Agent Faraji is in the utility closet. 

Faraji can ask about the phone exchange.

>knock door
After a few seconds, someone inserts a key in the lock and opens the door. It's Faraji's colleague Moira Zin. "How'd you get in there, Larch?"

You exit the closet.

Agent Faraji is in Moira's office. 

Also here is Moira Zin.

A phone is ringing somewhere else not too far away.

Wearing the astral lenses in fluorescent light is blinding. Faraji quickly removes the glasses.

Faraji can tell Moira Zin about the hyperdimensional portal or tell Moira Zin to wait for the report.

>x books
On Moira's bookshelves are Tribes of New York, Applied Speculation, Biking to the Ferry: a Memoir, No Myth After All: A New Perspective on Troy and Twenty Great PhD Theses of the Twentieth Century.

A phone is ringing somewhere else not too far away.

Faraji can ask to borrow a book, tell Moira Zin about the hyperdimensional portal or tell Moira Zin to wait for the report.

* * *

>look behind desk
There are a number of shelves of office supplies behind the desk. There is also a heating vent on the floor here.

Faraji finds their computer and pulls it out.

A phone is ringing somewhere else not too far away.

Faraji can ask about the phone exchange.

>take computer
Faraji's computer is a too unwieldy to carry around.

Taken.

A phone is ringing somewhere else not too far away.

Faraji can ask about the phone exchange.

>x computer
Faraji's computer has been damaged beyond repair. But they do find a thumb drive and take it.

A phone is ringing somewhere else not too far away.

Faraji can remember finding the drive. They can ask about the phone exchange.

>take boxes
Faraji picks up a couple of boxes and flattens them.

Margaret says, "Hey, what are you doing with those boxes, Agent Faraji? You don't have to worry about that -- I'll get them." She takes the flattened boxes from Faraji and hustles off.

A phone is ringing somewhere else not too far away.

Margaret goes west.

>take boxes
Faraji picks up a couple of boxes and flattens them.

A phone is ringing somewhere else not too far away.

>drop boxes
(the flattened boxes)
Dropped.

A phone is ringing somewhere else not too far away.

>take them
Faraji's carrying too many things already.

A phone is ringing somewhere else not too far away.

>i
Faraji is carrying:
  a thumb drive
  their computer

A phone is ringing somewhere else not too far away.

* * *

>take box
Faraji picks up a couple of boxes and flattens them.

Margaret says, "Hey, what are you doing with those boxes, Agent Faraji? You don't have to worry about that -- I'll get them." She takes the flattened boxes from Faraji and hustles off.

A phone is ringing somewhere else not too far away.

Margaret goes west.

* * *

>take box
Faraji picks up a couple of boxes and flattens them.

A phone is ringing somewhere else not too far away.

>w
Agent Faraji is in the hallway. Their office is to the south, Klimp's is to the west, and Moira's is to the north. The front office is east.

A phone is ringing to the south.

>s
Agent Faraji is in their office. They pause and survey the scene. It's not much -- four white walls, grey industrial carpet. Margaret has helpfully assembled Faraji's desk and chair, though how sturdily is an open question. She also took the time to put up some of Agent Faraji's office decor -- their degree in Nonstandard Investigative Techniques, an original pencil drawing of the Pitfall snake by semi-acclaimed Washington DC artist Darius 5200, and a photo of their soccer team. At the very least the wall coverings help compensate for the lack of windows. There's a disconnected landline on the desk. The office door is to the north, and there's a white metal door to the west.

Faraji mutters, "Where's my computer?"

A phone is ringing inside their desk.

Margaret goes west.

>w
Agent Faraji is in the back lot. This is a small area of asphalt between the building and a chain link fence looking in on an industrial property. A door to east leads into the BOSH offices, and one to the north enters the laundromat. There is a blue dumpster here.

Also here is Margaret.

A phone is ringing to the east, in Faraji's office.

Margaret tosses the flattened boxes over the edge of the dumpster.

Faraji can ask about the status of the computer or ask about the phone exchange.

>put boxes in dumpster
Faraji tosses the flattened boxes over the edge of the dumpster.

A phone is ringing to the east, in their office.

Margaret goes east.

>e
Agent Faraji is in their office. It's basically four white walls and grey carpet. There's a cheap desk and chair, and a disconnected phone on the desk. In lieu of windows, there are a few things on the wall: their degree in Nonstandard Investigative Techniques, a pencil drawing of the Pitfall snake, and a photo of their soccer team. The office door is to the north, and there's a white metal door to the west.

Also here is Margaret.

A phone is ringing inside Faraji's desk.

Margaret closes the white metal door.

Margaret locks the white metal door.

Faraji can ask about the status of the computer or ask about the phone exchange.

>n
Agent Faraji is in the hallway. Their office is to the south, Klimp's is to the west, and Moira's is to the north. The front office is east.

A phone is ringing to the south, in their office.

Margaret arrives from the south.

>e
Agent Faraji is in the front office. It's really a small storefront done up to resemble an office. A store sales counter serves as a front desk, behind which are located shelves of office supplies and a row of drawers. There are also a couch and coffee table here creating a makeshift seating area. An old department store clothing rack serves as a coatrack. Photos on the walls picture the Bureau in better days. A stack of used and empty cardboard boxes sits in one corner.

A phone is ringing somewhere else not too far away.

Margaret arrives from the west.

Faraji can ask about the status of the computer or ask about the phone exchange.

>take boxes
Faraji picks up a couple of boxes and flattens them.

Margaret says, "Hey, what are you doing with those boxes, Agent Faraji? You don't have to worry about that -- I'll get them." She takes the flattened boxes from Faraji and hustles off.

A phone is ringing somewhere else not too far away.

Margaret goes west.

* * *

>take boxes
Faraji picks up a couple of boxes and flattens them.

A phone is ringing somewhere else not too far away.

>drop them
Faraji doesn't have that.

A phone is ringing somewhere else not too far away.

>drop boxes
(the flattened boxes)
Dropped.

A phone is ringing somewhere else not too far away.

>i
Faraji is carrying nothing.

A phone is ringing somewhere else not too far away.

>l
Agent Faraji is in the front office. It's really a small storefront done up to resemble an office. A store sales counter serves as a front desk, behind which are located shelves of office supplies and a row of drawers. There are also a couch and coffee table here creating a makeshift seating area. An old department store clothing rack serves as a coatrack. Photos on the walls picture the Bureau in better days. A stack of used and empty cardboard boxes sits in one corner.

Also here are some flattened boxes.

A phone is ringing somewhere else not too far away.

>take boxes
(the flattened boxes)
Taken.

A phone is ringing somewhere else not too far away.

>take boxes
(the flattened boxes)
Faraji already has those.

A phone is ringing somewhere else not too far away.

>z
Faraji stands around and waits.

A phone is ringing somewhere else not too far away.

Margaret arrives from the west.

Faraji can ask about the status of the computer or ask about the phone exchange.

>give boxes to margaret
(the flattened boxes to Margaret)
That doesn't seem to be a topic of conversation at the moment.

A phone is ringing somewhere else not too far away.

Faraji can ask about the status of the computer or ask about the phone exchange.

>drop boxes
(the flattened boxes)
Dropped.

A phone is ringing somewhere else not too far away.

Faraji can ask about the status of the computer or ask about the phone exchange.

>take them
Taken.

A phone is ringing somewhere else not too far away.

Faraji can ask about the status of the computer or ask about the phone exchange.

>flatten boxes
(the flattened boxes)
They've already been flattened.

A phone is ringing somewhere else not too far away.

Faraji can ask about the status of the computer or ask about the phone exchange.

>drop them
Dropped.

A phone is ringing somewhere else not too far away.

Faraji can ask about the status of the computer or ask about the phone exchange.

>flatten boxes
(the flattened boxes)
They've already been flattened.

A phone is ringing somewhere else not too far away.

Faraji can ask about the status of the computer or ask about the phone exchange.

>take them
Taken.

A phone is ringing somewhere else not too far away.

Faraji can ask about the status of the computer or ask about the phone exchange.

>give them to margaret
That doesn't seem to be a topic of conversation at the moment.

A phone is ringing somewhere else not too far away.

Faraji can ask about the status of the computer or ask about the phone exchange.

* * *

>take box
Faraji picks up a couple of boxes and flattens them.

A phone is ringing somewhere else not too far away.

>z
Faraji stands around and waits.

A phone is ringing somewhere else not too far away.

>z
Faraji stands around and waits.

A phone is ringing somewhere else not too far away.

>z
Faraji stands around and waits.

A phone is ringing somewhere else not too far away.

Margaret arrives from the west.

Faraji can ask about the phone exchange.

>take box
Faraji already has as many boxes as they can carry.

A phone is ringing somewhere else not too far away.

Faraji can ask about the phone exchange.

>drop box
Faraji doesn't have that.

A phone is ringing somewhere else not too far away.

Faraji can ask about the phone exchange.

>i
Faraji is carrying:
  some flattened boxes

A phone is ringing somewhere else not too far away.

Faraji can ask about the phone exchange.

>drop flattened
Dropped.

A phone is ringing somewhere else not too far away.

Faraji can ask about the phone exchange.

>take box
Faraji already has as many boxes as they can carry.

A phone is ringing somewhere else not too far away.

Faraji can ask about the phone exchange.

>i
Faraji is carrying nothing.

A phone is ringing somewhere else not too far away.

Faraji can ask about the phone exchange.

>gonear closet
(the utility closet)
Agent Faraji is in the dark. 

Some light would be nice.

Faraji can ask about the phone exchange.

* * *

>lens
Agent Faraji is in the utility closet. 

Faraji can ask about the phone exchange.

>open door
It seems to be locked.

Faraji can ask about the phone exchange.

>knock on door
After a few seconds, someone inserts a key in the lock and opens the door. It's Faraji's colleague Moira Zin. "How'd you get in there, Larch?"

You exit the closet.

Agent Faraji is in Moira's office. 

Also here is Moira Zin.

A phone is ringing somewhere else not too far away.

Wearing the astral lenses in fluorescent light is blinding. Faraji quickly removes the glasses.

Faraji can tell Moira Zin about the hyperdimensional portal or tell Moira Zin to wait for the report.

>x books
On Moira's bookshelves are Tribes of New York, Applied Speculation, Biking to the Ferry: a Memoir, No Myth After All: A New Perspective on Troy and Twenty Great PhD Theses of the Twentieth Century.

A phone is ringing somewhere else not too far away.

Faraji can tell Moira Zin about the hyperdimensional portal or tell Moira Zin to wait for the report.

>borrow book
I'm not sure what you're trying to say. I might just not recognize the words you're using.

>take tribes
That belongs to Moira Zin.

A phone is ringing somewhere else not too far away.

Faraji can tell Moira Zin about the hyperdimensional portal or tell Moira Zin to wait for the report.

>ask to borrow book
I'm not sure what you're trying to say. I might just not recognize the words you're using.

>ask to borrow tribes
I'm not sure what you're trying to say. I might just not recognize the words you're using.

>x tribes
There seems to be nothing special about it.

A phone is ringing somewhere else not too far away.

Faraji can ask to borrow a book, tell Moira Zin about the hyperdimensional portal or tell Moira Zin to wait for the report.

>borrow a book
A phone is ringing somewhere else not too far away.

Faraji can ask to borrow a book, tell Moira Zin about the hyperdimensional portal or tell Moira Zin to wait for the report.

Moira Zin asks, "What do you want to borrow?"

>w
Faraji can't go that way.

A phone is ringing somewhere else not too far away.

Faraji can ask to borrow a book, tell Moira Zin about the hyperdimensional portal or tell Moira Zin to wait for the report.

>borrow
A phone is ringing somewhere else not too far away.

Faraji can ask to borrow a book, tell Moira Zin about the hyperdimensional portal or tell Moira Zin to wait for the report.

Moira Zin asks, "What do you want to borrow?"

* * *

>tribes
Faraji takes Tribes of New York.

A phone is ringing somewhere else not too far away.

Faraji can tell Moira Zin about the hyperdimensional portal or tell Moira Zin to wait for the report.

>borrow
Moira shakes her head. "Sorry, I'll only lend one book at a time."

A phone is ringing somewhere else not too far away.

Faraji can tell Moira Zin about the hyperdimensional portal or tell Moira Zin to wait for the report.

>give book
There's nothing like that nearby.

>give tribes
(to Moira Zin)
Moira smiles. "Thanks for getting it back to me." She puts the book back on the shelf.

A phone is ringing somewhere else not too far away.

Faraji can ask to borrow a book, tell Moira Zin about the hyperdimensional portal or tell Moira Zin to wait for the report.

>borrow
A phone is ringing somewhere else not too far away.

Faraji can ask to borrow a book, tell Moira Zin about the hyperdimensional portal or tell Moira Zin to wait for the report.

Moira Zin asks, "What do you want to borrow?"

>these
I'm not sure what you're trying to say. I might just not recognize the words you're using.

Moira Zin asks, "What do you want to borrow?"

>theses
Faraji takes Twenty Great PhD Theses of the Twentieth Century.

A phone is ringing somewhere else not too far away.

Faraji can tell Moira Zin about the hyperdimensional portal or tell Moira Zin to wait for the report.

* * *

>drop it
Dropped.

A phone is ringing somewhere else not too far away.

Faraji can tell Moira Zin about the hyperdimensional portal or tell Moira Zin to wait for the report.

>i
Faraji is carrying:
  a pair of astral lenses

A phone is ringing somewhere else not too far away.

Faraji can tell Moira Zin about the hyperdimensional portal or tell Moira Zin to wait for the report.

>borrow
Moira shakes her head. "Sorry, I'll only lend one book at a time."

A phone is ringing somewhere else not too far away.

Faraji can tell Moira Zin about the hyperdimensional portal or tell Moira Zin to wait for the report.

* * *

>give book
There's nothing like that nearby.

>give tome
There's nothing like that nearby.

>i
Faraji is carrying:
  a pair of astral lenses

A phone is ringing somewhere else not too far away.

Faraji can tell Moira Zin about the hyperdimensional portal or tell Moira Zin to wait for the report.

>take tome
There's nothing like that nearby.

>l
Agent Faraji is in Moira's office. 

Also here are Twenty Great PhD Theses of the Twentieth Century and Moira Zin.

A phone is ringing somewhere else not too far away.

Faraji can tell Moira Zin about the hyperdimensional portal or tell Moira Zin to wait for the report.

>take theses
That belongs to Moira Zin.

A phone is ringing somewhere else not too far away.

Faraji can tell Moira Zin about the hyperdimensional portal or tell Moira Zin to wait for the report.

>borrow
Moira shakes her head. "Sorry, I'll only lend one book at a time."

A phone is ringing somewhere else not too far away.

Faraji can tell Moira Zin about the hyperdimensional portal or tell Moira Zin to wait for the report.

>i
Faraji is carrying:
  a pair of astral lenses

A phone is ringing somewhere else not too far away.

Faraji can tell Moira Zin about the hyperdimensional portal or tell Moira Zin to wait for the report.

* * *

>take boxes
Faraji picks up a couple of boxes and flattens them.

Margaret says, "Hey, what are you doing with those boxes, Agent Faraji? You don't have to worry about that -- I'll get them." She takes the flattened boxes from Faraji and hustles off.

A phone is ringing somewhere else not too far away.

Margaret goes west.

* * *

>take boxes
Faraji picks up a couple of boxes and flattens them.

A phone is ringing somewhere else not too far away.

>w
Agent Faraji is in the hallway. Their office is to the south, Klimp's is to the west, and Moira's is to the north. The front office is east.

A phone is ringing to the south.

>drop boxes
Dropped.

A phone is ringing to the south.

>z
Faraji stands around and waits.

A phone is ringing to the south.

>z
Faraji stands around and waits.

A phone is ringing to the south.

>z
Faraji stands around and waits.

A phone is ringing to the south.

Margaret arrives from the south.

>z
Faraji stands around and waits.

A phone is ringing to the south.

Margaret picks up the flattened boxes.

>z
Faraji stands around and waits.

A phone is ringing to the south.

Margaret goes south.

>s
Agent Faraji is in their office. They pause and survey the scene. It's not much -- four white walls, grey industrial carpet. Margaret has helpfully assembled Faraji's desk and chair, though how sturdily is an open question. She also took the time to put up some of Agent Faraji's office decor -- their degree in Nonstandard Investigative Techniques, an original pencil drawing of the Pitfall snake by semi-acclaimed Washington DC artist Darius 5200, and a photo of their soccer team. At the very least the wall coverings help compensate for the lack of windows. There's a disconnected landline on the desk. The office door is to the north, and there's a white metal door to the west.

Faraji mutters, "Where's my computer?"

A phone is ringing inside their desk.

Margaret unlocks the white metal door.

Faraji can ask about the status of the computer or ask about the phone exchange.

>z
Faraji stands around and waits.

A phone is ringing inside their desk.

Margaret goes west.

* * *

>z
Faraji stands around and waits.

A phone is ringing to the south.

Margaret goes south.

>z
Faraji stands around and waits.

A phone is ringing to the south.

>zw
I'm not sure what you're trying to say. I might just not recognize the words you're using.

>w
(first opening Klimp's door)
It seems to be locked.

A phone is ringing to the south.

>e
Agent Faraji is in the front office. It's really a small storefront done up to resemble an office. A store sales counter serves as a front desk, behind which are located shelves of office supplies and a row of drawers. There are also a couch and coffee table here creating a makeshift seating area. An old department store clothing rack serves as a coatrack. Photos on the walls picture the Bureau in better days. A stack of used and empty cardboard boxes sits in one corner.

A phone is ringing somewhere else not too far away.

>s
Faraji can't go that way.

A phone is ringing somewhere else not too far away.

>n
Faraji can't go that way.

A phone is ringing somewhere else not too far away.

>w
Agent Faraji is in the hallway. Their office is to the south, Klimp's is to the west, and Moira's is to the north. The front office is east.

Also here is Margaret.

A phone is ringing to the south.

Faraji can ask about the phone exchange.

>x margaret
Margaret is the latest occupant of the rapidly revolving post of office manager. Most of her job involves ordering stationery and office supplies, shredding documents, and keeping track of office equipment.

A phone is ringing to the south.

Faraji can ask about the phone exchange.

* * *

>drop boxes
Dropped.

A phone is ringing inside Faraji's desk.

>z
Faraji stands around and waits.

A phone is ringing inside their desk.

Margaret arrives from the west.

>z
Faraji stands around and waits.

A phone is ringing inside their desk.

Margaret looks thoughtful. "Could have sworn I threw these boxes away," she says.

Margaret picks up the flattened boxes.

>z
Faraji stands around and waits.

A phone is ringing inside their desk.

Margaret goes west.

>z
Faraji stands around and waits.

A phone is ringing inside their desk.

>z
Faraji stands around and waits.

A phone is ringing inside their desk.

Margaret arrives from the west.

>z
Faraji stands around and waits.

A phone is ringing inside their desk.

Margaret closes the white metal door.

Margaret locks the white metal door.

* * *

>w
Agent Faraji is in the back lot. This is a small area of asphalt between the building and a chain link fence looking in on an industrial property. A door to east leads into the BOSH offices, and one to the north enters the laundromat. There is a blue dumpster here.

Also here is Margaret.

A phone is ringing to the east, in Faraji's office.

Margaret tosses the flattened boxes over the edge of the dumpster.

Faraji can ask about the status of the computer or ask about the phone exchange.

>z
Faraji stands around and waits.

A phone is ringing to the east, in their office.

Margaret sees the boxes in your hands and says, "No, no, give those to me." She takes them from your hands.

Faraji can ask about the status of the computer or ask about the phone exchange.

>z
Faraji stands around and waits.

A phone is ringing to the east, in their office.

Margaret tosses the flattened boxes over the edge of the dumpster.

Faraji can ask about the status of the computer or ask about the phone exchange.

>z
Faraji stands around and waits.

A phone is ringing to the east, in their office.

Margaret goes east.

>e
Agent Faraji is in their office. It's basically four white walls and grey carpet. There's a cheap desk and chair, and a disconnected phone on the desk. In lieu of windows, there are a few things on the wall: their degree in Nonstandard Investigative Techniques, a pencil drawing of the Pitfall snake, and a photo of their soccer team. The office door is to the north, and there's a white metal door to the west.

Also here is Margaret.

A phone is ringing inside Faraji's desk.

Margaret closes the white metal door.

Margaret locks the white metal door.

Faraji can ask about the status of the computer or ask about the phone exchange.

>gonear closet
(the utility closet)
Agent Faraji is in the dark. 

Some light would be nice.

* * *

>knock door
After a few seconds, someone inserts a key in the lock and opens the door. It's Faraji's colleague Moira Zin. "How'd you get in there, Larch?"

You exit the closet.

Agent Faraji is in Moira's office. 

Also here is Moira Zin.

A phone is ringing somewhere else not too far away.

Wearing the astral lenses in fluorescent light is blinding. Faraji quickly removes the glasses.

Faraji can tell Moira Zin about the hyperdimensional portal or tell Moira Zin to wait for the report.

>x books
On Moira's bookshelves are Tribes of New York, Applied Speculation, Biking to the Ferry: a Memoir, No Myth After All: A New Perspective on Troy and Twenty Great PhD Theses of the Twentieth Century.

A phone is ringing somewhere else not too far away.

Faraji can tell Moira Zin about the hyperdimensional portal or tell Moira Zin to wait for the report.

* * *

>take boxes
Faraji picks up a couple of boxes and flattens them.

A phone is ringing somewhere else not too far away.

>z
Faraji stands around and waits.

A phone is ringing somewhere else not too far away.

* * *

>z
Faraji stands around and waits.

A phone is ringing somewhere else not too far away.

Margaret arrives from the west.

Faraji can ask about the phone exchange.

>give boxes
(the flattened boxes to Margaret)
foo
A phone is ringing somewhere else not too far away.

Faraji can ask about the phone exchange.

>take boxes
(the flattened boxes)
Faraji already has those.

A phone is ringing somewhere else not too far away.

Faraji can ask about the phone exchange.

>drop them
Dropped.

A phone is ringing somewhere else not too far away.

Faraji can ask about the phone exchange.

>take boxes
(the flattened boxes)
Taken.

A phone is ringing somewhere else not too far away.

Faraji can ask about the phone exchange.

>take box
Faraji already has as many boxes as they can carry.

A phone is ringing somewhere else not too far away.

Faraji can ask about the phone exchange.