Department of Homeland Security, Washington, DC
Open on a drab office with decor dating to the mid-eighties. The DHS assistant to the associate sub-director looks longingly at the office clock nearing five, then leans across the desk and impatiently states his demands:

"First name, last name, pronouns?"

(1) Ezra Gaunt (he/him), winner of the 2006 Baltimore County Edgar Allan Poe Trivia Competition;

(2) Petula Clark Goldberg (she/her), former award-winning dog groomer of the avant-garde school;

or (3) Larch Faraji (they/them), lead singer of the third wave neo-old-school punk band DC Trash.

1, 2, or 3?

>2
Agent Goldberg is at the south end of the strip mall parking lot. From here one can see just how humble BOSH's state has become: the office is to the west, between a pawn shop (to the southwest) and a run-down laundromat (to the northwest) and across from an automatic car wash. To the south is a swampy area separating the lot from the interstate. The parking lot continues north.

Her Hyundai is parked nearby.

>directions
Which do you mean, the north, the northeast, the northwest, the south, the southeast, the southwest, the east, the west, the up, the down, the inside, the outside, back, forth, forthnorth, fortheast, forthsouth, forthwest, backnorth, backeast, backsouth or backwest?

>exits
The obvious exits are north, northwest, southwest, west and inside.

(Use EXITS ON to enable the status line exit lister and EXITS OFF to turn it off.)

>in
Just like in the store this once was, the door chimes as Goldberg walks in.

Agent Goldberg is in the front office. It's really a small storefront done up to resemble an office. A store sales counter serves as a front desk, behind which are located shelves of office supplies and a row of drawers. There are also a couch and coffee table here creating a makeshift seating area. An old department store clothing rack serves as a coatrack. Photos on the walls picture the Bureau in better days. A stack of used and empty cardboard boxes sits in one corner.

The Bureau's latest office manager, Margaret is bustling around with unrestrained enthusiasm, unpacking boxes and assembling an approximation of a respectable front office, all as if the Bureau isn't going to be shut down before the year is out. She sees Goldberg and practically squeals. "Agent Goldberg! I'm sorry -- Petula! How are you? I hope you don't mind -- I took the liberty of putting your desk together. I just love hex wrenches, don't you? Also, your new phone is here. I put it in your desk. Now I just need you to give me your old phone so I can deactivate it."

Goldberg hands Margaret her old phone. Margaret taps a few keys on her computer and says "There! All settled."

"Oh, good", Goldberg says. "Our phone downgrades have arrived from our bureaucratic betters."

A phone is ringing somewhere else not too far away.

Goldberg can ask about the phone exchange.

* * *

>3
Agent Faraji is at the south end of the strip mall parking lot. From here one can see just how humble BOSH's state has become: the office is to the west, between a pawn shop (to the southwest) and a run-down laundromat (to the northwest) and across from an automatic car wash. To the south is a swampy area separating the lot from the interstate. The parking lot continues north.

Their Hyundai is parked nearby.

* * *

>x laundromat
Faraji peers through the windows of the laundromat at the rows of aging machines. A sign on the door says "Closed for renovations". They turn away, unimpressed.

>x windows
They haven't been washed for a while. Through them you can see the sad state of the crumbling laundromat.

>x machine
There's nothing like that nearby.

>x machines
There's nothing like that nearby.

* * *

>3
Agent Faraji is at the south end of the strip mall parking lot. From here one can see just how humble BOSH's state has become: the office is to the west, between a pawn shop (to the southwest) and a run-down laundromat (to the northwest) and across from an automatic car wash. To the south is a swampy area separating the lot from the interstate. The parking lot continues north.

Their Hyundai is parked nearby.

>gonear broadcast tower
Agent Faraji is on the radio station roof. They can see the obelisk in the part clearly from here. The broadcast tower rises many feet above them.

>u
Faraji is afraid of heights.

>climb tower
Faraji is afraid of heights.

* * *

>3
Agent Faraji is at the south end of the strip mall parking lot. From here one can see just how humble BOSH's state has become: the office is to the west, between a pawn shop (to the southwest) and a run-down laundromat (to the northwest) and across from an automatic car wash. To the south is a swampy area separating the lot from the interstate. The parking lot continues north.

Their Hyundai is parked nearby.

>w
Just like in the store this once was, the door chimes as Faraji walks in.

Agent Faraji is in the front office. It's really a small storefront done up to resemble an office. A store sales counter serves as a front desk, behind which are located shelves of office supplies and a row of drawers. There are also a couch and coffee table here creating a makeshift seating area. An old department store clothing rack serves as a coatrack. Photos on the walls picture the Bureau in better days. A stack of used and empty cardboard boxes sits in one corner.

The Bureau's latest office manager, Margaret is bustling around with unrestrained enthusiasm, unpacking boxes and assembling an approximation of a respectable front office, all as if the Bureau isn't going to be shut down before the year is out. She sees Faraji and practically squeals. "Agent Faraji! I'm sorry -- Larch! How are you? I hope you don't mind -- I took the liberty of putting your desk together. I just love hex wrenches, don't you? Also, your new phone is here. I put it in your desk. Now I just need you to give me your old phone so I can deactivate it."

"Oh, good", Faraji says. "Our phone downgrades have arrived from our bureaucratic betters."

Faraji hands Margaret their old phone. Margaret taps a few keys on her computer and says "There! All settled."

A phone is ringing somewhere else not too far away.

Faraji can ask about the phone exchange.

>ask about phone
Faraji asks, "Tell me what's going on with the phones again?"

Margaret looks apologetic. "I'm sorry, I thought everyone knew. Budget cuts. They're trading in all our smart phones for cheaper models."

A phone is ringing somewhere else not too far away.

>w
Faraji extricates themself from talking with Margaret.

Agent Faraji is in the hallway. Their office is to the south, Klimp's is to the west, and Moira's is to the north. The front office is east.

A phone is ringing to the south.

>s
Agent Faraji is in their office. They pause and survey the scene. It's not much -- four white walls, grey industrial carpet. Margaret has helpfully assembled Faraji's desk and chair, though how sturdily is an open question. She also took the time to put up some of Agent Faraji's office decor -- their degree in Nonstandard Investigative Techniques, an original pencil drawing of the Pitfall snake by semi-acclaimed Washington DC artist Darius 5200, and a photo of their soccer team. At the very least the wall coverings help compensate for the lack of windows. There's a disconnected landline on the desk. The office door is to the north, and there's a white metal door to the west.

Faraji mutters, "Where's my computer?"

A phone is ringing inside their desk.

>w
(first opening the white metal door)
It seems to be locked.

A phone is ringing inside Faraji's desk.

* * *

>n
Agent Faraji is in the hallway. Their office is to the south, Klimp's is to the west, and Moira's is to the north. The front office is east.

A phone is ringing to the south, in their office.

>w
(first opening Klimp's door)
It seems to be locked.

A phone is ringing to the south, in Faraji's office.

>n
(first opening Moira's door)
It seems to be locked.

A phone is ringing to the south, in Faraji's office.

>e
Agent Faraji is in the front office. It's really a small storefront done up to resemble an office. A store sales counter serves as a front desk, behind which are located shelves of office supplies and a row of drawers. There are also a couch and coffee table here creating a makeshift seating area. An old department store clothing rack serves as a coatrack. Photos on the walls picture the Bureau in better days. A stack of used and empty cardboard boxes sits in one corner.

The Bureau's latest office manager, Margaret is bustling around with unrestrained enthusiasm.

A phone is ringing somewhere else not too far away.

Faraji can ask about the status of the computer or ask to unlock the backdoor.

>ask about backdoor
Faraji asks, "Could you unlock the back door, Margaret?"

"Sorry, too busy right now. What do you want back there anyway? There's only a dumpster." She pauses for a moment and mutters to herself. "Which reminds me, I need to get these boxes broken down."

A phone is ringing somewhere else not too far away.

Faraji can ask about the status of the computer.

* * *

>x laundromat
Faraji peers through the windows of the laundromat at the rows of aging machines. A sign on the door says "Closed for renovations". They turn away, unimpressed.

>x laundromat windows
I only understood you as far as wanting to examine the A-plus laundromat.

* * *

>gonear main street
Agent Faraji is on the 200 block of Main Street. The street runs east and west from here. South is the edifice of Rolle's Department Store. North is the town hall.

>s
Agent Faraji is in Rolle's Department Store. Once, town department stores like this were a constant of American life. Sadly, this one is empty of everything save a number of sale posters and its gleaming floor.

A floor waxer sits in the center of the gleaming floor.

>x waxer
This is a bulky, heavy-duty machine with a large, round brush head, designed for durability and the ability to polish vast floor areas to a high shine.

>take it
It's too heavy to lift.

>gonear gym
Which do you mean, Lake Street by the gym, the gym basement, the gym door or the gym front desk?

>gonear gym front desk
Agent Faraji is in the public gymnasium. There is a basketball court and a weight training area. A front desk is next to the front entrance.

>x desk
Some kind of record book sits on the front desk.

On the gym front desk is a membership book.

>take book
You hardly need it, and it might useful to someone else.

>move book
Faraji can't move that.

* * *

>take book
You hardly need it, and it might useful to someone else.

>w
(first opening the gym door)
It seems to be locked.

>showme gym door
gym door - locked door
location: in the public gymnasium
singular-named, improper-named, unmarked for special listing; unlit, inedible, fixed in place, scenery, neuter, seen, familiar, quiet, background; closed, openable, lockable, locked
list grouping key: none
printed name: "gym door"
printed plural name: "doors"
indefinite article: none
most recent reference: nominal
third singular pronoun: It-pronoun
summary: none
description: none
initial appearance: none
dark description: none
hearability: very loud
volume: 0.0
price: $0
behind description: none
third-plural-pronoun: They-pronoun
possessive: none
portrait: Figure Null
other side: Lake Street by the gym

>gonear department store
Which do you mean, the department store sign, Rolle's Department Store or Rolle's Department Store?

>rolle's
(Rolle's Department Store)
Agent Faraji is in Rolle's Department Store. Once, town department stores like this were a constant of American life. Sadly, this one is empty of everything save a number of sale posters and its gleaming floor.

A floor waxer sits in the center of the gleaming floor.

>x department
Agent Faraji is in Rolle's Department Store. Once, town department stores like this were a constant of American life. Sadly, this one is empty of everything save a number of sale posters and its gleaming floor.

A floor waxer sits in the center of the gleaming floor.

>move waxer
Faraji can't move that.

>x posters
"50% off everything in the store!"

>x waxer
This is a bulky, heavy-duty machine with a large, round brush head, designed for durability and the ability to polish vast floor areas to a high shine.

>n
Agent Faraji is on the 200 block of Main Street. The street runs east and west from here. South is the edifice of Rolle's Department Store. North is the town hall.

>x door
There's nothing like that nearby.

>w
Agent Faraji is on the corner of Main and Solvay. Main Street runs east from here, while Solvay Road heads north. South of here, Henry's Hot Skillet promises all of the comforts of the mid-twentieth-century diner. A book store named The Reading Room lies to the west, while Fresnel's Music is southwest.

>s
(first opening the Skillet door)
It seems to be locked.

>e
Agent Faraji is on the 200 block of Main Street. The street runs east and west from here. South is the edifice of Rolle's Department Store. North is the town hall.

>e
Agent Faraji is at the intersection of Main and Lake. Main goes west, while Lake runs north. The corner of the town hall is to the northwest, although it cannot be entered there. Southeast is the entrance to WGXC "Galaxy" Radio. There is a broadcast tower on top of the building.

>n
Agent Faraji is walking on Lake Street by the gym.

* * *

>n
Agent Faraji is walking on Lake Street by the park.

>n
Agent Faraji is at the intersection of Lake Street and Ridge Road. The intersection lies at the edge of the lake. Lake Street runs south into town, while Ridge Road heads off into the darkness east of here. A little park along the lake shore is to the west.

There is an abandoned pickup truck at the side of the road.

>enter truck
Faraji can't get into the closed abandoned pickup truck.

>open it
Faraji opens the abandoned pickup truck, revealing nothing.

>enter truck
Agent Faraji is at the intersection of Lake Street and Ridge Road. They are in the abandoned pickup truck. There is a glove compartment on the passenger side, closed.

The intersection lies at the edge of the lake. Lake Street runs south into town, while Ridge Road heads off into the darkness east of here. A little park along the lake shore is to the west.

>open glove
Faraji opens the glove compartment, revealing a brass key.

>take key
Taken.

>w
Faraji would have to get out of the abandoned pickup truck first.

>out
Faraji gets out of the abandoned pickup truck.

Agent Faraji is at the intersection of Lake Street and Ridge Road. The intersection lies at the edge of the lake. Lake Street runs south into town, while Ridge Road heads off into the darkness east of here. A little park along the lake shore is to the west.

There is an abandoned pickup truck at the side of the road.

>s
Agent Faraji is walking on Lake Street by the park.

>s
Agent Faraji is walking on Lake Street by the gym.

>w
You can't enter the town hall from here.

>s
Agent Faraji is at the intersection of Main and Lake. Main goes west, while Lake runs north. The corner of the town hall is to the northwest, although it cannot be entered there. Southeast is the entrance to WGXC "Galaxy" Radio. There is a broadcast tower on top of the building.

The seeming sound of sibilant speech carries on the breeze.

>w
Agent Faraji is on the 200 block of Main Street. The street runs east and west from here. South is the edifice of Rolle's Department Store. North is the town hall.

>w
Agent Faraji is on the corner of Main and Solvay. Main Street runs east from here, while Solvay Road heads north. South of here, Henry's Hot Skillet promises all of the comforts of the mid-twentieth-century diner. A book store named The Reading Room lies to the west, while Fresnel's Music is southwest.

* * *

>s
(first opening the Skillet door)
It seems to be locked.

>unlock door with key
Faraji unlocks the Skillet door.

>s
(first opening the Skillet door)
Agent Faraji is in Henry's Hot Skillet. This is the epitome of the homey small-town diner of times go by, except for the lack of all furniture, cooking implements, food, decor, and so on. There is a staircase leading up. A pair of insulated wires hangs from the ceiling at one end of the counter.

>u
Agent Faraji is on Henry's Roof. From here one can see much of the town, including a clear view of the obelisk in Enigma Park. There is a large TV aerial antenna jutting from the roof here.

>x antenna
A large, metallic rooftop antenna, characterized by its array of horizontal and vertical rods designed to capture VHF (very high frequency) broadcasts.

>i
Faraji is carrying:
  a brass key
  a green smartphone

>tie key to antenna
I'm not sure what you're trying to say. I might just not recognize the words you're using.

>attach
I'm not sure what you're trying to say. I might just not recognize the words you're using.

* * *

>x antenna
A large, metallic rooftop antenna, characterized by its array of horizontal and vertical rods designed to capture VHF (very high frequency) broadcasts.

>take it
Faraji can't take that.

>x enigma park
There's a clear line of sight from here to the tip of the obelisk.

>l
Agent Faraji is in Henry's Roof. From here one can see much of the town, including a clear view of the obelisk in Enigma Park. There is a large TV aerial antenna jutting from the roof here.

>d
Agent Faraji is in Henry's Hot Skillet. This is the epitome of the homey small-town diner of times go by, except for the lack of all furniture, cooking implements, food, decor, and so on. There is a staircase leading up. A pair of insulated wires hangs from the ceiling at one end of the counter.

>x wires
Two insulated wires with bare ends, they probably once attached to some electrical device sitting on the counter.

* * *

>take it
It's too heavy to lift.

>n
Agent Faraji is on 200 block of Main Street. The street runs east and west from here. South is the edifice of Rolle's Department Store. North is the town hall.

>nw
Go north to enter the town hall.

>ne
Go north to enter the town hall.

>sw
You can go north into the town hall, or south into Rolle's Department Store. In addition, Main Street leads east and west.

>w
Agent Faraji is on the corner of Main and Solvay. Main Street runs east from here, while Solvay Road heads north. South of here, Henry's Hot Skillet promises all of the comforts of the mid-twentieth-century diner. A book store named The Reading Room lies to the west, while Fresnel's Music is southwest.

>ne
Faraji can't go that way.

>enter town hall
That's not something Faraji can enter.

>ne
Faraji can't go that way.

>e
Agent Faraji is on 200 block of Main Street. The street runs east and west from here. South is the edifice of Rolle's Department Store. North is the town hall.

>e
Agent Faraji is at the intersection of Main and Lake. Main goes west, while Lake runs north. The corner of the town hall is to the northwest, although it cannot be entered there. Southeast is the entrance to WGXC "Galaxy" Radio. There is a broadcast tower on top of the building.

>b
Faraji can't go that way.

>n
Agent Faraji is walking on Lake Street by the gym.

>sw
You can't enter the town hall from here.

>bw
Faraji can't go that way.

>w
You can't enter the town hall from here.

>nw
You can't enter the town hall from here.

>se
Faraji can't go that way.

>ne
Faraji can't go that way.

>e
(first opening the gym door)
It seems to be locked.