Department of Homeland Security, Washington, DC
Open on a drab office with decor dating to the mid-eighties. The DHS assistant to the associate sub-director looks longingly at the office clock nearing five, then leans across the desk and impatiently states his demands:

"First name, last name, pronouns, biographical trivia?"

(1) Ezra Gaunt (he/him), winner of the 2006 Baltimore County Edgar Allan Poe Trivia Competition;

(2) Petula Clark Goldberg (she/her), former award-winning dog groomer of the avant-garde school;

or (3) Larch Faraji (they/them), lead singer of the third wave neo-old-school punk band DC Trash.

The Bureau of Strange Happenings
An Interactive Phenomenon by Phil Riley
Release 1 / Serial number 230507 / Inform 7 build 6M62 (I6/v6.34 lib 6/12N) SD

Agent Faraji is at the south end of the strip mall parking lot. From here one can see just how humble BOSH's state has become: the office is to the west, between a pawn shop (to the southwest) and a run-down laundromat (to the northwest) and across from an automatic car wash. To the south is a swampy area separating the lot from the interstate. The parking lot continues north.

Their Hyundai is parked nearby.

>gonear enigma park
Agent Faraji is in Enigma Park.

>e
Agent Faraji is in Lake Street by the Park.

>s
Agent Faraji is in Lake Street by the Courthouse.

* * *

>s
Agent Faraji is in Main at Lake.

>s
Faraji can't go that way.

>e
Faraji can't go that way.

>se
Faraji can't go that way.

>w
Agent Faraji is in Main Street 200 Block.

>w
Agent Faraji is in Main at Solvay.

>n
Agent Faraji is in Solvay Road by the Fire Station.

>e
Agent Faraji is in Solvay Road by the Fire Station.

>e
Agent Faraji is in Solvay Road by the Fire Station.

* * *

>gonear enigma park
Agent Faraji is in Enigma Park.

>w
Faraji can't go that way.

>n
Agent Faraji is on the lake shore north of the park.

* * *

>s
Agent Faraji is in Enigma Park.

>e
Agent Faraji is in Lake Street by the Park.

* * *

>s
Agent Faraji is in Lake Street by the Courthouse.

>w
Agent Faraji is in Lake Street by the Courthouse.

>w
Agent Faraji is in Lake Street by the Courthouse.

* * *

>gonear hook
Agent Faraji is in Hook and Ladder Company #1.

>e
Agent Faraji is walking on Solvay Road by the fire station.

>n
Agent Faraji is walking on Solvay Road leading out of town.

>n
Agent Faraji is at the west end of the town's lake shore.

* * *

>w
Faraji can't go that way.

>e
Agent Faraji is on the lake shore north of the park.

>s
Agent Faraji is in Enigma Park.

* * *

>s
Agent Faraji is on the 200 block of Main Street.

>versions
That's not a verb I recognise.

>verion
That's not a verb I recognise.

>version
The Bureau of Strange Happenings
An Interactive Phenomenon by Phil Riley
Release 1 / Serial number 230506 / Inform 7 build 6M62 (I6/v6.34 lib 6/12N) SD
Identification number: //F61EFB05-03A9-4894-B076-9E767F9163A8//
Interpreter version 0.5.2 / VM 3.1.2 / Library serial number 080126
Standard Rules version 3/120430 by Graham Nelson
Epistemology version 9 by Eric Eve
Conversation Framework version 12 by Eric Eve
Conversation Responses version 7 by Eric Eve
Conversational Defaults version 3 by Eric Eve
Formatting Capture version 2/221014 by Daniel Stelzer (based on Text Capture by Eric Eve)
Essentials by Philip Riley
Facts by Philip Riley
Phones by Philip Riley
Commerce by Philip Riley
Furniture by Philip Riley
Third Person Narration by Philip Riley
Door Utils by Philip Riley
Real People by Philip Riley
New Light by Philip Riley
Early Declarations by Philip Riley
Farseeing by Philip Riley
Basics by Philip Riley
Memories by Philip Riley
Hyperspace by Philip Riley
BOSH Facts by Philip Riley
Image Strip by Philip Riley
Simple Conversation by Philip Riley
Swamp Park by Philip Riley
Conversations General by Philip Riley
Margaret by Philip Riley
Enigma Lake by Philip Riley
Gender Options version 3/210331 by Nathanael Nerode
Hearing by Philip Riley
Far Away version 5/160517 by Jon Ingold

* * *

>gonear hyperplane
Agent Faraji is on a featureless hyperplane. They rub their eyes as they try to take in their surroundings. In addition to the usual directions of north and south and east and west, two new directions exist here: back and forth. As a result, the "surface" they're standing on is in fact a three-dimensional hyperplane. Up and down still exist, and there is gravity, apparently.

As far as one can see, the hyperplane extends infinitely in all six directions.

In the middle distance is some kind of structure, roughly to the forth.

>f
Agent Faraji is on a featureless hyperplane.  In addition to the usual directions of north and south and east and west, two new directions exist here: back and forth. As a result, the "surface" they're standing on is in fact a three-dimensional hyperplane. Up and down still exist, and there is gravity, apparently.

As far as one can see, the hyperplane extends infinitely in all six directions.

In the middle distance is some kind of structure, roughly to the forth.

>f
Agent Faraji is on a featureless hyperplane.  In addition to the usual directions of north and south and east and west, two new directions exist here: back and forth. As a result, the "surface" they're standing on is in fact a three-dimensional hyperplane. Up and down still exist, and there is gravity, apparently.

As far as one can see, the hyperplane extends infinitely in all six directions.

In the middle distance is some kind of structure, roughly to the forth.

>f
Agent Faraji is on a featureless hyperplane.  In addition to the usual directions of north and south and east and west, two new directions exist here: back and forth. As a result, the "surface" they're standing on is in fact a three-dimensional hyperplane. Up and down still exist, and there is gravity, apparently.

As far as one can see, the hyperplane extends infinitely in all six directions.

Not too far off is some kind of structure, roughly to the forth.

>f
Agent Faraji is on a featureless hyperplane.  In addition to the usual directions of north and south and east and west, two new directions exist here: back and forth. As a result, the "surface" they're standing on is in fact a three-dimensional hyperplane. Up and down still exist, and there is gravity, apparently.

As far as one can see, the hyperplane extends infinitely in all six directions.

Not too far off is some kind of structure, roughly to the forth.

>f
Agent Faraji is on a featureless hyperplane.  In addition to the usual directions of north and south and east and west, two new directions exist here: back and forth. As a result, the "surface" they're standing on is in fact a three-dimensional hyperplane. Up and down still exist, and there is gravity, apparently.

As far as one can see, the hyperplane extends infinitely in all six directions.

Not too far off is some kind of structure, roughly to the forthnorth.

>fn
Agent Faraji is on a featureless hyperplane.  In addition to the usual directions of north and south and east and west, two new directions exist here: back and forth. As a result, the "surface" they're standing on is in fact a three-dimensional hyperplane. Up and down still exist, and there is gravity, apparently.

As far as one can see, the hyperplane extends infinitely in all six directions.

Not too far off is some kind of structure, roughly to the forthwest.

>fw
Agent Faraji is on a featureless hyperplane.  In addition to the usual directions of north and south and east and west, two new directions exist here: back and forth. As a result, the "surface" they're standing on is in fact a three-dimensional hyperplane. Up and down still exist, and there is gravity, apparently.

As far as one can see, the hyperplane extends infinitely in all six directions.

Not too far off is some kind of structure, roughly to the forthnorth.

>fn
Agent Faraji is on a featureless hyperplane.  In addition to the usual directions of north and south and east and west, two new directions exist here: back and forth. As a result, the "surface" they're standing on is in fact a three-dimensional hyperplane. Up and down still exist, and there is gravity, apparently.

As far as one can see, the hyperplane extends infinitely in all six directions.

Not too far off is some kind of structure, roughly to the forthnorth.

>fn
Agent Faraji is on a featureless hyperplane.  In addition to the usual directions of north and south and east and west, two new directions exist here: back and forth. As a result, the "surface" they're standing on is in fact a three-dimensional hyperplane. Up and down still exist, and there is gravity, apparently.

As far as one can see, the hyperplane extends infinitely in all six directions.

Not too far off is some kind of structure, roughly to the forthwest.

>fw
Agent Faraji is on a featureless hyperplane.  In addition to the usual directions of north and south and east and west, two new directions exist here: back and forth. As a result, the "surface" they're standing on is in fact a three-dimensional hyperplane. Up and down still exist, and there is gravity, apparently.

As far as one can see, the hyperplane extends infinitely in all six directions.

Not too far off is some kind of structure, roughly to the west.

>w
Agent Faraji is on a featureless hyperplane.  In addition to the usual directions of north and south and east and west, two new directions exist here: back and forth. As a result, the "surface" they're standing on is in fact a three-dimensional hyperplane. Up and down still exist, and there is gravity, apparently.

As far as one can see, the hyperplane extends infinitely in all six directions.

Close by is some kind of structure to the forthnorth.

>fn
Agent Faraji is on a featureless hyperplane.  In addition to the usual directions of north and south and east and west, two new directions exist here: back and forth. As a result, the "surface" they're standing on is in fact a three-dimensional hyperplane. Up and down still exist, and there is gravity, apparently.

As far as one can see, the hyperplane extends infinitely in all six directions.

Close by is some kind of structure to the west.

>w
Agent Faraji is next to an ethereal pillar.  In addition to the usual directions of north and south and east and west, two new directions exist here: back and forth. As a result, the "surface" they're standing on is in fact a three-dimensional hyperplane. Up and down still exist, and there is gravity, apparently.

As far as one can see, the hyperplane extends infinitely in all six directions.

There is an ethereal pillar here. A message carved into the pillar says "Seek the origin. -Doris"

A mystic compass dangles from an outcropping of the pillar.

>take compass
Taken.

>x it
On the readout of the mystic compass floats a set of ethereal symbols: ┘┐ : ┘┌ : ┘└

>e
Agent Faraji is on a featureless hyperplane.  In addition to the usual directions of north and south and east and west, two new directions exist here: back and forth. As a result, the "surface" they're standing on is in fact a three-dimensional hyperplane. Up and down still exist, and there is gravity, apparently.

As far as one can see, the hyperplane extends infinitely in all six directions.

On the readout of the mystic compass floats a set of ethereal symbols: ┘┐ : ┘┐ : ┘└

Close by is some kind of structure to the west.

>drop compass
The mystic compass vanishes!

>l
Agent Faraji is on a featureless hyperplane.  In addition to the usual directions of north and south and east and west, two new directions exist here: back and forth. As a result, the "surface" they're standing on is in fact a three-dimensional hyperplane. Up and down still exist, and there is gravity, apparently.

As far as one can see, the hyperplane extends infinitely in all six directions.

Close by is some kind of structure to the west.

>w
Agent Faraji is next to an ethereal pillar.  In addition to the usual directions of north and south and east and west, two new directions exist here: back and forth. As a result, the "surface" they're standing on is in fact a three-dimensional hyperplane. Up and down still exist, and there is gravity, apparently.

As far as one can see, the hyperplane extends infinitely in all six directions.

There is an ethereal pillar here. A message carved into the pillar says "Seek the origin. -Doris"

A mystic compass dangles from an outcropping of the pillar.

* * *

>take compass
Taken.

>drop it
The mystic compass vanishes and reappears, dangling from the pillar!

>take it
Taken.

>undo
ethereal pillar
[Previous turn undone.]

>l
Agent Faraji is next to an ethereal pillar.  In addition to the usual directions of north and south and east and west, two new directions exist here: back and forth. As a result, the "surface" they're standing on is in fact a three-dimensional hyperplane. Up and down still exist, and there is gravity, apparently.

As far as one can see, the hyperplane extends infinitely in all six directions.

A mystic compass dangles from an outcropping of the pillar.

There is an ethereal pillar here. A message carved into the pillar says "Seek the origin. -Doris"

>take compass
Taken.

>l
Agent Faraji is next to an ethereal pillar.  In addition to the usual directions of north and south and east and west, two new directions exist here: back and forth. As a result, the "surface" they're standing on is in fact a three-dimensional hyperplane. Up and down still exist, and there is gravity, apparently.

As far as one can see, the hyperplane extends infinitely in all six directions.

There is an ethereal pillar here. A message carved into the pillar says "Seek the origin. -Doris"

On the readout of the mystic compass floats a set of ethereal symbols: ┘┐ : ┘┌ : ┘└

>e
Agent Faraji is on a featureless hyperplane.  In addition to the usual directions of north and south and east and west, two new directions exist here: back and forth. As a result, the "surface" they're standing on is in fact a three-dimensional hyperplane. Up and down still exist, and there is gravity, apparently.

As far as one can see, the hyperplane extends infinitely in all six directions.

On the readout of the mystic compass floats a set of ethereal symbols: ┘┐ : ┘┐ : ┘└

Close by is some kind of structure to the west.

>s
Agent Faraji is on a featureless hyperplane.  In addition to the usual directions of north and south and east and west, two new directions exist here: back and forth. As a result, the "surface" they're standing on is in fact a three-dimensional hyperplane. Up and down still exist, and there is gravity, apparently.

As far as one can see, the hyperplane extends infinitely in all six directions.

On the readout of the mystic compass floats a set of ethereal symbols: ┘┘ : ┘┐ : ┘└

Close by is some kind of structure to the northwest.

>w
Agent Faraji is on a featureless hyperplane.  In addition to the usual directions of north and south and east and west, two new directions exist here: back and forth. As a result, the "surface" they're standing on is in fact a three-dimensional hyperplane. Up and down still exist, and there is gravity, apparently.

As far as one can see, the hyperplane extends infinitely in all six directions.

On the readout of the mystic compass floats a set of ethereal symbols: ┘┘ : ┘┌ : ┘└

Close by is some kind of structure to the north.

>w
Agent Faraji is on a featureless hyperplane.  In addition to the usual directions of north and south and east and west, two new directions exist here: back and forth. As a result, the "surface" they're standing on is in fact a three-dimensional hyperplane. Up and down still exist, and there is gravity, apparently.

As far as one can see, the hyperplane extends infinitely in all six directions.

On the readout of the mystic compass floats a set of ethereal symbols: ┘┘ : ┘└ : ┘└

Close by is some kind of structure to the northeast.

>w
Agent Faraji is on a featureless hyperplane.  In addition to the usual directions of north and south and east and west, two new directions exist here: back and forth. As a result, the "surface" they're standing on is in fact a three-dimensional hyperplane. Up and down still exist, and there is gravity, apparently.

As far as one can see, the hyperplane extends infinitely in all six directions.

On the readout of the mystic compass floats a set of ethereal symbols: ┘┘ : ┐◊ : ┘└

Not too far off is some kind of structure, roughly to the northeast.

>w
Agent Faraji is on a featureless hyperplane.  In addition to the usual directions of north and south and east and west, two new directions exist here: back and forth. As a result, the "surface" they're standing on is in fact a three-dimensional hyperplane. Up and down still exist, and there is gravity, apparently.

As far as one can see, the hyperplane extends infinitely in all six directions.

On the readout of the mystic compass floats a set of ethereal symbols: ┘┘ : ┐┘ : ┘└

Not too far off is some kind of structure, roughly to the east.

>w
Agent Faraji is on a featureless hyperplane.  In addition to the usual directions of north and south and east and west, two new directions exist here: back and forth. As a result, the "surface" they're standing on is in fact a three-dimensional hyperplane. Up and down still exist, and there is gravity, apparently.

As far as one can see, the hyperplane extends infinitely in all six directions.

On the readout of the mystic compass floats a set of ethereal symbols: ┘┘ : ┐┐ : ┘└

Not too far off is some kind of structure, roughly to the east.

>w
Agent Faraji is on a featureless hyperplane.  In addition to the usual directions of north and south and east and west, two new directions exist here: back and forth. As a result, the "surface" they're standing on is in fact a three-dimensional hyperplane. Up and down still exist, and there is gravity, apparently.

As far as one can see, the hyperplane extends infinitely in all six directions.

On the readout of the mystic compass floats a set of ethereal symbols: ┘┘ : ┐┌ : ┘└

Not too far off is some kind of structure, roughly to the east.

>w
Agent Faraji is on a featureless hyperplane.  In addition to the usual directions of north and south and east and west, two new directions exist here: back and forth. As a result, the "surface" they're standing on is in fact a three-dimensional hyperplane. Up and down still exist, and there is gravity, apparently.

As far as one can see, the hyperplane extends infinitely in all six directions.

On the readout of the mystic compass floats a set of ethereal symbols: ┘┘ : ┐└ : ┘└

Not too far off is some kind of structure, roughly to the east.

>w
Agent Faraji is on a featureless hyperplane.  In addition to the usual directions of north and south and east and west, two new directions exist here: back and forth. As a result, the "surface" they're standing on is in fact a three-dimensional hyperplane. Up and down still exist, and there is gravity, apparently.

As far as one can see, the hyperplane extends infinitely in all six directions.

On the readout of the mystic compass floats a set of ethereal symbols: ┘┘ : ┌◊ : ┘└

Not too far off is some kind of structure, roughly to the east.

>e
Agent Faraji is on a featureless hyperplane.  In addition to the usual directions of north and south and east and west, two new directions exist here: back and forth. As a result, the "surface" they're standing on is in fact a three-dimensional hyperplane. Up and down still exist, and there is gravity, apparently.

As far as one can see, the hyperplane extends infinitely in all six directions.

On the readout of the mystic compass floats a set of ethereal symbols: ┘┘ : ┐└ : ┘└

Not too far off is some kind of structure, roughly to the east.

>e
Agent Faraji is on a featureless hyperplane.  In addition to the usual directions of north and south and east and west, two new directions exist here: back and forth. As a result, the "surface" they're standing on is in fact a three-dimensional hyperplane. Up and down still exist, and there is gravity, apparently.

As far as one can see, the hyperplane extends infinitely in all six directions.

On the readout of the mystic compass floats a set of ethereal symbols: ┘┘ : ┐┌ : ┘└

Not too far off is some kind of structure, roughly to the east.

>e
Agent Faraji is on a featureless hyperplane.  In addition to the usual directions of north and south and east and west, two new directions exist here: back and forth. As a result, the "surface" they're standing on is in fact a three-dimensional hyperplane. Up and down still exist, and there is gravity, apparently.

As far as one can see, the hyperplane extends infinitely in all six directions.

On the readout of the mystic compass floats a set of ethereal symbols: ┘┘ : ┐┐ : ┘└

Not too far off is some kind of structure, roughly to the east.

>e
Agent Faraji is on a featureless hyperplane.  In addition to the usual directions of north and south and east and west, two new directions exist here: back and forth. As a result, the "surface" they're standing on is in fact a three-dimensional hyperplane. Up and down still exist, and there is gravity, apparently.

As far as one can see, the hyperplane extends infinitely in all six directions.

On the readout of the mystic compass floats a set of ethereal symbols: ┘┘ : ┐┘ : ┘└

Not too far off is some kind of structure, roughly to the east.

>e
Agent Faraji is on a featureless hyperplane.  In addition to the usual directions of north and south and east and west, two new directions exist here: back and forth. As a result, the "surface" they're standing on is in fact a three-dimensional hyperplane. Up and down still exist, and there is gravity, apparently.

As far as one can see, the hyperplane extends infinitely in all six directions.

On the readout of the mystic compass floats a set of ethereal symbols: ┘┘ : ┐◊ : ┘└

Not too far off is some kind of structure, roughly to the northeast.

>e
Agent Faraji is on a featureless hyperplane.  In addition to the usual directions of north and south and east and west, two new directions exist here: back and forth. As a result, the "surface" they're standing on is in fact a three-dimensional hyperplane. Up and down still exist, and there is gravity, apparently.

As far as one can see, the hyperplane extends infinitely in all six directions.

On the readout of the mystic compass floats a set of ethereal symbols: ┘┘ : ┘└ : ┘└

Close by is some kind of structure to the northeast.

>e
Agent Faraji is on a featureless hyperplane.  In addition to the usual directions of north and south and east and west, two new directions exist here: back and forth. As a result, the "surface" they're standing on is in fact a three-dimensional hyperplane. Up and down still exist, and there is gravity, apparently.

As far as one can see, the hyperplane extends infinitely in all six directions.

On the readout of the mystic compass floats a set of ethereal symbols: ┘┘ : ┘┌ : ┘└

Close by is some kind of structure to the north.

>e
Agent Faraji is on a featureless hyperplane.  In addition to the usual directions of north and south and east and west, two new directions exist here: back and forth. As a result, the "surface" they're standing on is in fact a three-dimensional hyperplane. Up and down still exist, and there is gravity, apparently.

As far as one can see, the hyperplane extends infinitely in all six directions.

On the readout of the mystic compass floats a set of ethereal symbols: ┘┘ : ┘┐ : ┘└

Close by is some kind of structure to the northwest.

>e
Agent Faraji is on a featureless hyperplane.  In addition to the usual directions of north and south and east and west, two new directions exist here: back and forth. As a result, the "surface" they're standing on is in fact a three-dimensional hyperplane. Up and down still exist, and there is gravity, apparently.

As far as one can see, the hyperplane extends infinitely in all six directions.

On the readout of the mystic compass floats a set of ethereal symbols: ┘┘ : ┘┘ : ┘└

Not too far off is some kind of structure, roughly to the northwest.

>e
Agent Faraji is on a featureless hyperplane.  In addition to the usual directions of north and south and east and west, two new directions exist here: back and forth. As a result, the "surface" they're standing on is in fact a three-dimensional hyperplane. Up and down still exist, and there is gravity, apparently.

As far as one can see, the hyperplane extends infinitely in all six directions.

On the readout of the mystic compass floats a set of ethereal symbols: ┘┘ : ┘◊ : ┘└

Not too far off is some kind of structure, roughly to the west.

>e
Agent Faraji is on a featureless hyperplane.  In addition to the usual directions of north and south and east and west, two new directions exist here: back and forth. As a result, the "surface" they're standing on is in fact a three-dimensional hyperplane. Up and down still exist, and there is gravity, apparently.

As far as one can see, the hyperplane extends infinitely in all six directions.

On the readout of the mystic compass floats a set of ethereal symbols: ┘┘ : └ : ┘└

Not too far off is some kind of structure, roughly to the west.

>e
Agent Faraji is on a featureless hyperplane.  In addition to the usual directions of north and south and east and west, two new directions exist here: back and forth. As a result, the "surface" they're standing on is in fact a three-dimensional hyperplane. Up and down still exist, and there is gravity, apparently.

As far as one can see, the hyperplane extends infinitely in all six directions.

On the readout of the mystic compass floats a set of ethereal symbols: ┘┘ : ┌ : ┘└

Not too far off is some kind of structure, roughly to the west.

>e
Agent Faraji is on a featureless hyperplane.  In addition to the usual directions of north and south and east and west, two new directions exist here: back and forth. As a result, the "surface" they're standing on is in fact a three-dimensional hyperplane. Up and down still exist, and there is gravity, apparently.

As far as one can see, the hyperplane extends infinitely in all six directions.

On the readout of the mystic compass floats a set of ethereal symbols: ┘┘ : ┐ : ┘└

Not too far off is some kind of structure, roughly to the west.

>e
Agent Faraji is on a featureless hyperplane.  In addition to the usual directions of north and south and east and west, two new directions exist here: back and forth. As a result, the "surface" they're standing on is in fact a three-dimensional hyperplane. Up and down still exist, and there is gravity, apparently.

As far as one can see, the hyperplane extends infinitely in all six directions.

On the readout of the mystic compass floats a set of ethereal symbols: ┘┘ : ┘ : ┘└

Not too far off is some kind of structure, roughly to the west.

>e
Agent Faraji is on a featureless hyperplane.  In addition to the usual directions of north and south and east and west, two new directions exist here: back and forth. As a result, the "surface" they're standing on is in fact a three-dimensional hyperplane. Up and down still exist, and there is gravity, apparently.

As far as one can see, the hyperplane extends infinitely in all six directions.

On the readout of the mystic compass floats a set of ethereal symbols: ┘┘ : ◊ : ┘└

Not too far off is some kind of structure, roughly to the west.

>f
Agent Faraji is on a featureless hyperplane.  In addition to the usual directions of north and south and east and west, two new directions exist here: back and forth. As a result, the "surface" they're standing on is in fact a three-dimensional hyperplane. Up and down still exist, and there is gravity, apparently.

As far as one can see, the hyperplane extends infinitely in all six directions.

On the readout of the mystic compass floats a set of ethereal symbols: ┘┘ : ◊ : ┐◊

Not too far off is some kind of structure, roughly to the west.

>b
Agent Faraji is on a featureless hyperplane.  In addition to the usual directions of north and south and east and west, two new directions exist here: back and forth. As a result, the "surface" they're standing on is in fact a three-dimensional hyperplane. Up and down still exist, and there is gravity, apparently.

As far as one can see, the hyperplane extends infinitely in all six directions.

On the readout of the mystic compass floats a set of ethereal symbols: ┘┘ : ◊ : ┘└

Not too far off is some kind of structure, roughly to the west.

>b
Agent Faraji is on a featureless hyperplane.  In addition to the usual directions of north and south and east and west, two new directions exist here: back and forth. As a result, the "surface" they're standing on is in fact a three-dimensional hyperplane. Up and down still exist, and there is gravity, apparently.

As far as one can see, the hyperplane extends infinitely in all six directions.

On the readout of the mystic compass floats a set of ethereal symbols: ┘┘ : ◊ : ┘┌

Not too far off is some kind of structure, roughly to the west.

>b
Agent Faraji is on a featureless hyperplane.  In addition to the usual directions of north and south and east and west, two new directions exist here: back and forth. As a result, the "surface" they're standing on is in fact a three-dimensional hyperplane. Up and down still exist, and there is gravity, apparently.

As far as one can see, the hyperplane extends infinitely in all six directions.

On the readout of the mystic compass floats a set of ethereal symbols: ┘┘ : ◊ : ┘┐

Not too far off is some kind of structure, roughly to the west.

>b
Agent Faraji is on a featureless hyperplane.  In addition to the usual directions of north and south and east and west, two new directions exist here: back and forth. As a result, the "surface" they're standing on is in fact a three-dimensional hyperplane. Up and down still exist, and there is gravity, apparently.

As far as one can see, the hyperplane extends infinitely in all six directions.

On the readout of the mystic compass floats a set of ethereal symbols: ┘┘ : ◊ : ┘┘

Not too far off is some kind of structure, roughly to the west.

>b
Agent Faraji is on a featureless hyperplane.  In addition to the usual directions of north and south and east and west, two new directions exist here: back and forth. As a result, the "surface" they're standing on is in fact a three-dimensional hyperplane. Up and down still exist, and there is gravity, apparently.

As far as one can see, the hyperplane extends infinitely in all six directions.

On the readout of the mystic compass floats a set of ethereal symbols: ┘┘ : ◊ : ┘◊

Not too far off is some kind of structure, roughly to the west.

>b
Agent Faraji is on a featureless hyperplane.  In addition to the usual directions of north and south and east and west, two new directions exist here: back and forth. As a result, the "surface" they're standing on is in fact a three-dimensional hyperplane. Up and down still exist, and there is gravity, apparently.

As far as one can see, the hyperplane extends infinitely in all six directions.

On the readout of the mystic compass floats a set of ethereal symbols: ┘┘ : ◊ : └

Not too far off is some kind of structure, roughly to the forthwest.

>b
Agent Faraji is on a featureless hyperplane.  In addition to the usual directions of north and south and east and west, two new directions exist here: back and forth. As a result, the "surface" they're standing on is in fact a three-dimensional hyperplane. Up and down still exist, and there is gravity, apparently.

As far as one can see, the hyperplane extends infinitely in all six directions.

On the readout of the mystic compass floats a set of ethereal symbols: ┘┘ : ◊ : ┌

In the middle distance is some kind of structure, roughly to the forthwest.

>b
Agent Faraji is on a featureless hyperplane.  In addition to the usual directions of north and south and east and west, two new directions exist here: back and forth. As a result, the "surface" they're standing on is in fact a three-dimensional hyperplane. Up and down still exist, and there is gravity, apparently.

As far as one can see, the hyperplane extends infinitely in all six directions.

On the readout of the mystic compass floats a set of ethereal symbols: ┘┘ : ◊ : ┐

In the middle distance is some kind of structure, roughly to the forthwest.

>b
Agent Faraji is on a featureless hyperplane.  In addition to the usual directions of north and south and east and west, two new directions exist here: back and forth. As a result, the "surface" they're standing on is in fact a three-dimensional hyperplane. Up and down still exist, and there is gravity, apparently.

As far as one can see, the hyperplane extends infinitely in all six directions.

On the readout of the mystic compass floats a set of ethereal symbols: ┘┘ : ◊ : ┘

In the middle distance is some kind of structure, roughly to the forthwest.

>b
Agent Faraji is on a featureless hyperplane.  In addition to the usual directions of north and south and east and west, two new directions exist here: back and forth. As a result, the "surface" they're standing on is in fact a three-dimensional hyperplane. Up and down still exist, and there is gravity, apparently.

As far as one can see, the hyperplane extends infinitely in all six directions.

On the readout of the mystic compass floats a set of ethereal symbols: ┘┘ : ◊ : ◊

In the middle distance is some kind of structure, roughly to the forthwest.

>s
Agent Faraji is on a featureless hyperplane.  In addition to the usual directions of north and south and east and west, two new directions exist here: back and forth. As a result, the "surface" they're standing on is in fact a three-dimensional hyperplane. Up and down still exist, and there is gravity, apparently.

As far as one can see, the hyperplane extends infinitely in all six directions.

On the readout of the mystic compass floats a set of ethereal symbols: ┘◊ : ◊ : ◊

In the middle distance is some kind of structure, roughly to the forthwest.

>s
Agent Faraji is on a featureless hyperplane.  In addition to the usual directions of north and south and east and west, two new directions exist here: back and forth. As a result, the "surface" they're standing on is in fact a three-dimensional hyperplane. Up and down still exist, and there is gravity, apparently.

As far as one can see, the hyperplane extends infinitely in all six directions.

On the readout of the mystic compass floats a set of ethereal symbols: └ : ◊ : ◊

In the middle distance is some kind of structure, roughly to the forthwest.

>s
Agent Faraji is on a featureless hyperplane.  In addition to the usual directions of north and south and east and west, two new directions exist here: back and forth. As a result, the "surface" they're standing on is in fact a three-dimensional hyperplane. Up and down still exist, and there is gravity, apparently.

As far as one can see, the hyperplane extends infinitely in all six directions.

On the readout of the mystic compass floats a set of ethereal symbols: ┌ : ◊ : ◊

In the middle distance is some kind of structure, roughly to the forthwest.

>s
Agent Faraji is on a featureless hyperplane.  In addition to the usual directions of north and south and east and west, two new directions exist here: back and forth. As a result, the "surface" they're standing on is in fact a three-dimensional hyperplane. Up and down still exist, and there is gravity, apparently.

As far as one can see, the hyperplane extends infinitely in all six directions.

On the readout of the mystic compass floats a set of ethereal symbols: ┐ : ◊ : ◊

In the middle distance is some kind of structure, roughly to the forthwest.

>s
Agent Faraji is on a featureless hyperplane.  In addition to the usual directions of north and south and east and west, two new directions exist here: back and forth. As a result, the "surface" they're standing on is in fact a three-dimensional hyperplane. Up and down still exist, and there is gravity, apparently.

As far as one can see, the hyperplane extends infinitely in all six directions.

On the readout of the mystic compass floats a set of ethereal symbols: ┘ : ◊ : ◊

In the middle distance is some kind of structure, roughly to the forthnorth.

>ss
That's not a verb I recognise.

>s
Agent Faraji is at the top of a descending stair.  In addition to the usual directions of north and south and east and west, two new directions exist here: back and forth. As a result, the "surface" they're standing on is in fact a three-dimensional hyperplane. Up and down still exist, and there is gravity, apparently.

As far as one can see, the hyperplane extends infinitely in all six directions.

A spiraling staircase disappears into the ground here. It is made of the same gossamer, questionably real stuff as the ground, the pillar, and the readouts. You can't see past the first turn of the stairs, unfortunately.

On the readout of the mystic compass floats a set of ethereal symbols: ◊ : ◊ : ◊

In the middle distance is some kind of structure, roughly to the forthnorth.

>s
Agent Faraji is on a featureless hyperplane.  In addition to the usual directions of north and south and east and west, two new directions exist here: back and forth. As a result, the "surface" they're standing on is in fact a three-dimensional hyperplane. Up and down still exist, and there is gravity, apparently.

As far as one can see, the hyperplane extends infinitely in all six directions.

On the readout of the mystic compass floats a set of ethereal symbols: ┘⌂ : ◊ : ◊

In the middle distance is some kind of structure, roughly to the forthnorth.

>n
Agent Faraji is at the top of a descending stair.  In addition to the usual directions of north and south and east and west, two new directions exist here: back and forth. As a result, the "surface" they're standing on is in fact a three-dimensional hyperplane. Up and down still exist, and there is gravity, apparently.

As far as one can see, the hyperplane extends infinitely in all six directions.

A spiraling staircase disappears into the ground here. It is made of the same gossamer, questionably real stuff as the ground, the pillar, and the readouts. You can't see past the first turn of the stairs, unfortunately.

On the readout of the mystic compass floats a set of ethereal symbols: ◊ : ◊ : ◊

In the middle distance is some kind of structure, roughly to the forthnorth.

>d
Agent Faraji is at field office reception. Hooray you made it!

>gonear town hall
Agent Faraji is in the Enigma Lake town hall.

>undo
field office reception
[Previous turn undone.]

* * *

>gonear town hall
There seems to be no such object anywhere in the model world.

* * *

>test closet
(Testing.)

>[1] gonear closet
(the utility closet)
Agent Faraji is in the dark. 

It is pitch dark, and they can't see a thing.

>[2] purloin glasses
[Purloined.]

>[3] wear them
Faraji puts on the astral lenses.

Agent Faraji is in the utility closet. 

>[4] knock on door
After a few seconds, someone inserts a key in the lock and opens the door. It's Faraji's colleague Moira Zin. "How'd you get in there, Larch?"

You exit the closet.

Agent Faraji is in Moira's office. It, like Moira herself, is neat and orderly. She's clearly made the most of the meager funds she had for furnishing her office. Behind a modest yet functional desk is a modest yet functional office chair. Her bookshelves are filled with titles relating to investigative techniques, law, and skepticism. In the east wall is a closet door. The exit is to the south.

Also here is Moira Zin.

Faraji can tell Moira Zin about the hyperdimensional portal or tell Moira Zin to wait for the report.

>tell about portal
There's nothing like that nearby.

>tell zin about portal
1.

2.

* * *

>w
Just like in the store this once was, the door chimes as Faraji walks in.

Agent Faraji is in the front office. It's really a small storefront done up to resemble an office. A store sales counter serves as a front desk, behind which are located shelves of office supplies and a row of drawers. There are also a couch and coffee table here creating a makeshift seating area. An old department store clothing rack serves as a coatrack. Photos on the walls picture the Bureau in better days. A stack of used and empty cardboard boxes sits in one corner.

The Bureau's latest office manager, Margaret Chao is bustling around with unrestrained enthusiasm, unpacking boxes and assembling an approximation of a respectable front office, all as if the Bureau isn't going to be shut down before the year is out. She sees Faraji and practically squeals. "Agent Faraji! I'm sorry -- Larch! How are you? I hope you don't mind -- I took the liberty of putting your desk together. I just love hex wrenches, don't you? Also, your new phone is here. I put it in your desk. Good timing! Now I just need you to give me your old phone so I can deactivate it."

Faraji hands Margaret their old phone. Margaret taps a few keys on her computer and says "There! All settled. Hey, what are you doing for lunch? Let me know when you get hungry!"

A phone is ringing not too far away.

* * *

>x car
An old bright red Hyundai Accent, it's been Faraji's personal means of transportation for years. And since the Bureau lost its fleet, it's their work car too.

>w
Just like in the store this once was, the door chimes as Faraji walks in.

Agent Faraji is in the front office. It's really a small storefront done up to resemble an office. A store sales counter serves as a front desk, behind which are located shelves of office supplies and a row of drawers. There are also a couch and coffee table here creating a makeshift seating area. An old department store clothing rack serves as a coatrack. Photos on the walls picture the Bureau in better days. A stack of used and empty cardboard boxes sits in one corner.

The Bureau's latest office manager, Margaret Chao is bustling around with unrestrained enthusiasm, unpacking boxes and assembling an approximation of a respectable front office, all as if the Bureau isn't going to be shut down before the year is out. She sees Faraji and practically squeals. "Agent Faraji! I'm sorry -- Larch! How are you? I hope you don't mind -- I took the liberty of putting your desk together. I just love hex wrenches, don't you? Also, your new phone is here. I put it in your desk. Good timing! Now I just need you to give me your old phone so I can deactivate it."

Faraji hands Margaret their old phone. Margaret taps a few keys on her computer and says "There! All settled. Hey, what are you doing for lunch? Let me know when you get hungry!"

A phone is ringing not too far away.

>w
Faraji extricates themself from talking with Margaret.

Agent Faraji is in the hallway. Their office is to the south, Klimp's is to the west, and Moira's is to the north. The front office is east.

A phone is ringing to the south.

* * *

>x computer
There's nothing like that nearby.

>x desk
The desk is a cheap DIY piece held together with hex screws. It has a single drawer which is closed.

A phone is ringing inside Faraji's desk.

>open drawer
Faraji tries to open the desk to answer the phone, but it seems to be locked. They sigh. "Margaret must have the key."

A phone is ringing inside their desk.

>e
Faraji can't go that way.

A phone is ringing inside their desk.

* * *

>n
Agent Faraji is in the hallway. Their office is to the south, Klimp's is to the west, and Moira's is to the north. The front office is east.

A phone is ringing to the south.

>e
Agent Faraji is in the front office. It's really a small storefront done up to resemble an office. A store sales counter serves as a front desk, behind which are located shelves of office supplies and a row of drawers. There are also a couch and coffee table here creating a makeshift seating area. An old department store clothing rack serves as a coatrack. Photos on the walls picture the Bureau in better days. A stack of used and empty cardboard boxes sits in one corner.

The Bureau's latest office manager, Margaret Chao is bustling around with unrestrained enthusiasm.

A phone is ringing not too far away.

They can ask about the whereabouts of the desk key or ask about the status of the computer.

>ask for key
There's nothing like that nearby.

>ask about key
Faraji says, "Hey Margaret, do you know anything about my desk key?"

"Sure I do -- I put it in your desk." She furrows her brow. "What's the matter?"

A phone is ringing not too far away.

They can ask about the status of the computer or ask for the hex wrench.

>ask about computer
"Margaret", Faraji says, "what's up with my computer?"

"Oh, it got busted up during the move. I have the box behind my desk -- you can see it if you want. We'll have to get you a new one."

A phone is ringing not too far away.

They can ask for the hex wrench.

>look behind desk
There are a number of shelves of office supplies behind the desk. There is also a heating vent on the floor here.

Faraji finds a beat-up cardboard box and pulls it out.

A phone is ringing not too far away.

They can ask for the hex wrench.

>open box
Faraji opens the beat-up cardboard box, revealing their computer.

A phone is ringing not too far away.

They can ask for the hex wrench.

>x computer
Faraji's computer has been damaged beyond repair. But they do find a thumb drive and take it.

A phone is ringing not too far away.

They can remember finding the drive before.

They can ask for the hex wrench.

>x drive
It's a red plastic thumb drive, with what look like symbols scratched on the surface, but they're like no symbols you've ever seen. The metal USB end is somewhat corroded.

A phone is ringing not too far away.

Faraji can ask for the hex wrench.

>remember finding drive
Faraji remembers finding the drive in an ancient Onandaga root cellar on a farm in upstate New York. They have never been able to read it.

A phone is ringing not too far away.

They can ask for the hex wrench.

>ask about hex
Faraji says, "Do you happen to have the hex wrench from putting together my desk?"

"Well, I did, but I dropped it down a heating vent behind my desk."

A phone is ringing not too far away.

>look behind desk
There are a number of shelves of office supplies behind the desk. There is also a heating vent on the floor here.

A phone is ringing not too far away.

>x vent
A typical vent with a grill which one would hope would stop things like, say, a hex wrench from falling through. It's set in the floor behind the front desk. The vent is held closed by four screws.

In the heating vent is a hex wrench.

A phone is ringing not too far away.

Faraji can ask for a screwdriver.

>take wrench
Faraji's fingers won't fit through the openings in the vent. They"ll have to open it first.

A phone is ringing not too far away.

They can ask for a screwdriver.

>ask for screwdriver
Faraji asks, "Margaret, where's the screwdriver?"

"Umm... I think it was in a box we had to leave behind." Margaret looks embarrassed. "What? I never thought we'd need it. This isn't a construction site after all. Maybe if Klimp had paid for the bigger UHaul..." She stares past Faraji awkwardly.

A phone is ringing not too far away.

They can ask for a screwdriver.

>x margaret
Margaret is the latest occupant of the rapidly revolving post of office manager. Most of her job involves ordering stationery and office supplies, shredding documents, and keeping track of office equipment.

A phone is ringing not too far away.

Faraji can ask for a screwdriver.

>gonear closet
(the utility closet)
Agent Faraji is in the dark. 

It is pitch dark, and they can't see a thing.

They can ask for a screwdriver.

>knock on door
There's nothing like that nearby.

>purloin glasses
[Purloined.]

>wear them
Faraji puts on the astral lenses.

Agent Faraji is in the utility closet. 

They can ask for a screwdriver.

>knock on door
After a few seconds, someone inserts a key in the lock and opens the door. It's Faraji's colleague Moira Zin. "How'd you get in there, Larch?"

You exit the closet.

Agent Faraji is in Moira's office. It is, like Moira herself, neat and orderly. She's clearly made the most of the meager funds she had for furnishing her office. Behind a modest yet functional desk is a modest yet functional office chair. Her bookshelves are filled with titles relating to investigative techniques, law, and skepticism. In the east wall is a closet door. The exit is to the south.

Also here is Moira Zin.

Faraji can tell Moira Zin about the hyperdimensional portal or tell Moira Zin to wait for the report.

>tell her about the portal
1.

2.

>l
Agent Faraji is in Moira's office. It is, like Moira herself, neat and orderly. She's clearly made the most of the meager funds she had for furnishing her office. Behind a modest yet functional desk is a modest yet functional office chair. Her bookshelves are filled with titles relating to investigative techniques, law, and skepticism. In the east wall is a closet door. The exit is to the south.

Also here is Moira Zin.

>x zin
Agent Moira Zin is the very model of a competent Bureau agent. Hard-working, serious, no-nonsense but open-minded, she's the sober counter-balance to Klimp's sometimes childish credulity. Moira would clearly be a rising star if it weren't for the Bureau's pending dissolution.

>s
(first opening Moira's door)
It seems to be locked.