Department of Homeland Security, Washington, DC
Open on a drab office with decor dating to the mid-eighties. The DHS assistant to the associate sub-director looks longingly at the office clock nearing five, then leans across the desk and impatiently states his demands:

"First name, last name, pronouns?"

(1) Ezra Gaunt (he/him), winner of the 2006 Baltimore County Edgar Allan Poe Trivia Competition;

(2) Petula Clark Goldberg (she/her), former award-winning dog groomer of the avant-garde school;

or (3) Larch Faraji (they/them), lead singer of the third wave neo-old-school punk band DC Trash.

The Bureau of Strange Happenings
An Interactive Phenomenon by Phil Riley
Release 1 / Serial number 230518 / Inform 7 build 6M62 (I6/v6.34 lib 6/12N) SD

Agent Faraji is at the south end of the strip mall parking lot. From here one can see just how humble BOSH's state has become: the office is to the west, between a pawn shop (to the southwest) and a run-down laundromat (to the northwest) and across from an automatic car wash. To the south is a swampy area separating the lot from the interstate. The parking lot continues north.

Their Hyundai is parked nearby.

>rules off
[Rule "redirect to GEP line input rule" applies.]
[Rule "ordinary checking for content rule" applies.]
[Rule "After reading a command" applies.]
[Rule "declare everything initially unmentioned rule" applies.]
Rules tracing now switched off. Type "rules" to switch it on again.

>w
Just like in the store this once was, the door chimes as Faraji walks in.

Agent Faraji is in the front office. It's really a small storefront done up to resemble an office. A store sales counter serves as a front desk, behind which are located shelves of office supplies and a row of drawers. There are also a couch and coffee table here creating a makeshift seating area. An old department store clothing rack serves as a coatrack. Photos on the walls picture the Bureau in better days. A stack of used and empty cardboard boxes sits in one corner.

The Bureau's latest office manager, Margaret is bustling around with unrestrained enthusiasm, unpacking boxes and assembling an approximation of a respectable front office, all as if the Bureau isn't going to be shut down before the year is out. She sees Faraji and practically squeals. "Agent Faraji! I'm sorry -- Larch! How are you? I hope you don't mind -- I took the liberty of putting your desk together. I just love hex wrenches, don't you? Also, your new phone is here. I put it in your desk. Good timing! Now I just need you to give me your old phone so I can deactivate it."

Faraji hands Margaret their old phone. Margaret taps a few keys on her computer and says "There! All settled."

"Oh, good", Faraji says. "Our phone downgrades have arrived from our bureaucratic betters."

A phone is ringing not too far away.

Faraji can go east, west or outside.

>w
Faraji extricates themself from talking with Margaret.

Agent Faraji is in the hallway. Their office is to the south, Klimp's is to the west, and Moira's is to the north. The front office is east.

A phone is ringing to the south.

Faraji can go north, south, east or west.

>s
Agent Faraji is in their office. They pause and survey the scene. It's not much -- four white walls, grey industrial carpet. Margaret has helpfully assembled Faraji's desk and chair, though how sturdily is an open question. She also took the time to put up some of Agent Faraji's office decor -- their degree in Nonstandard Investigative Techniques, an original pencil drawing of the Pitfall snake by semi-acclaimed Washington DC artist Darius 5200, and a photo of their softball team. At the very least the wall coverings help compensate for the lack of windows. There's a disconnected landline on the desk. The office door is to the north, and there's a white metal door to the west.

Faraji mutters, "Where's my computer?"

A phone is ringing inside their desk.

Faraji can go north or west.

>rules
Rules tracing now switched on. Type "rules off" to switch it off again, or "rules all" to include even rules which do not apply.

[Rule "clear LPR rule" applies.]
[Rule "reset skip sounds rule" applies.]

* * *

>1
I'm not sure what you're trying to say. I might just not recognize the words you're using.

>w
Just like in the store this once was, the door chimes as Faraji walks in.

Agent Faraji is in the front office. It's really a small storefront done up to resemble an office. A store sales counter serves as a front desk, behind which are located shelves of office supplies and a row of drawers. There are also a couch and coffee table here creating a makeshift seating area. An old department store clothing rack serves as a coatrack. Photos on the walls picture the Bureau in better days. A stack of used and empty cardboard boxes sits in one corner.

The Bureau's latest office manager, Margaret is bustling around with unrestrained enthusiasm, unpacking boxes and assembling an approximation of a respectable front office, all as if the Bureau isn't going to be shut down before the year is out. She sees Faraji and practically squeals. "Agent Faraji! I'm sorry -- Larch! How are you? I hope you don't mind -- I took the liberty of putting your desk together. I just love hex wrenches, don't you? Also, your new phone is here. I put it in your desk. Good timing! Now I just need you to give me your old phone so I can deactivate it."

Faraji hands Margaret their old phone. Margaret taps a few keys on her computer and says "There! All settled."

"Oh, good", Faraji says. "Our phone downgrades have arrived from our bureaucratic betters."

A phone is ringing not too far away.

Faraji can go east, west or outside.

* * *

>attack wall
There are no walls.

Faraji can go north, northwest, southwest, west or inside.

>look up
There's nothing up there but sky.

Faraji can go north, northwest, southwest, west or inside.

>look down
Black asphalt.

Faraji can go north, northwest, southwest, west or inside.

>d
Faraji can't just dig downward.

Faraji can go north, northwest, southwest, west or inside.

>touch ground
Faraji feels nothing special about the ground.

Faraji can go north, northwest, southwest, west or inside.

>touch floor
Faraji feels nothing special about the ground.

Faraji can go north, northwest, southwest, west or inside.

>look down
Black asphalt.

Faraji can go north, northwest, southwest, west or inside.

>x floor
Black asphalt.

Faraji can go north, northwest, southwest, west or inside.

>nw
A sign on the laundromat door says "Closed for renovations".

Faraji can go north, northwest, southwest, west or inside.

>sw
(first opening the pawn shop door)
"Cha-ching!" rings the electronic chime as Faraji steps into the store.

Agent Faraji is in Dave's pawn shop. This is more the seedy, gloomy stereotype of a pawn shop than the glitzy sanitized version of TV reality shows. The blinds in the windows are closed to only allow the barest slant of sunlight in, leaving the sickly fluorescent lights to illuminate the room. There is the distinct smell of cigar smoke. The glass counter is filled with a large collection of possibly valuable items. Behind it is an impressive array of firearms.

A man, presumably Dave, stands behind the main counter eyeing Faraji.

The pawn shop door closes.

Faraji can go northeast (to the south end of the strip mall parking lot) or outside (to the south end of the strip mall parking lot).

>x floor
Dingy stained industrial carpet.

Faraji can go northeast (to the south end of the strip mall parking lot) or outside (to the south end of the strip mall parking lot).

* * *

>in
Just like in the store this once was, the door chimes as Faraji walks in.

Agent Faraji is in the front office. It's really a small storefront done up to resemble an office. A store sales counter serves as a front desk, behind which are located shelves of office supplies and a row of drawers. There are also a couch and coffee table here creating a makeshift seating area. An old department store clothing rack serves as a coatrack. Photos on the walls picture the Bureau in better days. A stack of used and empty cardboard boxes sits in one corner.

The Bureau's latest office manager, Margaret is bustling around with unrestrained enthusiasm, unpacking boxes and assembling an approximation of a respectable front office, all as if the Bureau isn't going to be shut down before the year is out. She sees Faraji and practically squeals. "Agent Faraji! I'm sorry -- Larch! How are you? I hope you don't mind -- I took the liberty of putting your desk together. I just love hex wrenches, don't you? Also, your new phone is here. I put it in your desk. Good timing! Now I just need you to give me your old phone so I can deactivate it."

Faraji hands Margaret their old phone. Margaret taps a few keys on her computer and says "There! All settled."

"Oh, good", Faraji says. "Our phone downgrades have arrived from our bureaucratic betters."

A phone is ringing not too far away.

They can go east, west or outside.

>out
Faraji steps out of the office into the parking lot.

Agent Faraji is at the south end of the strip mall parking lot. From here one can see just how humble BOSH's state has become: the office is to the west, between a pawn shop (to the southwest) and a run-down laundromat (to the northwest) and across from an automatic car wash. To the south is a swampy area separating the lot from the interstate. The parking lot continues north.

Their Hyundai is parked nearby.

They can go north, northwest, southwest, west or inside.

>w
Agent Faraji is in the front office. It's really a small storefront done up to resemble an office. A store sales counter serves as a front desk, behind which are located shelves of office supplies and a row of drawers. There are also a couch and coffee table here creating a makeshift seating area. An old department store clothing rack serves as a coatrack. Photos on the walls picture the Bureau in better days. A stack of used and empty cardboard boxes sits in one corner.

The Bureau's latest office manager, Margaret is bustling around with unrestrained enthusiasm.

A phone is ringing not too far away.

Faraji can go east, west or outside.

>e
Agent Faraji is at the south end of the strip mall parking lot. From here one can see just how humble BOSH's state has become: the office is to the west, between a pawn shop (to the southwest) and a run-down laundromat (to the northwest) and across from an automatic car wash. To the south is a swampy area separating the lot from the interstate. The parking lot continues north.

Their Hyundai is parked nearby.

They can go north, northwest, southwest, west or inside.

>w
Agent Faraji is in the front office. It's really a small storefront done up to resemble an office. A store sales counter serves as a front desk, behind which are located shelves of office supplies and a row of drawers. There are also a couch and coffee table here creating a makeshift seating area. An old department store clothing rack serves as a coatrack. Photos on the walls picture the Bureau in better days. A stack of used and empty cardboard boxes sits in one corner.

The Bureau's latest office manager, Margaret is bustling around with unrestrained enthusiasm.

A phone is ringing not too far away.

Faraji can go east, west or outside.

* * *

>e
Agent Faraji is at the south end of the strip mall parking lot. From here one can see just how humble BOSH's state has become: the office is to the west, between a pawn shop (to the southwest) and a run-down laundromat (to the northwest) and across from an automatic car wash. To the south is a swampy area separating the lot from the interstate. The parking lot continues north.

Their Hyundai is parked nearby.

They can go north, northwest, southwest, west or inside.

>exits off
Exit listing is now off.

>exits onn
I only understood you as far as wanting to exits.

>exits on
Exit listing is now on.

>w
Agent Faraji is in the front office. It's really a small storefront done up to resemble an office. A store sales counter serves as a front desk, behind which are located shelves of office supplies and a row of drawers. There are also a couch and coffee table here creating a makeshift seating area. An old department store clothing rack serves as a coatrack. Photos on the walls picture the Bureau in better days. A stack of used and empty cardboard boxes sits in one corner.

The Bureau's latest office manager, Margaret is bustling around with unrestrained enthusiasm.

A phone is ringing not too far away.

Faraji can go east, west or outside.

>w
Faraji extricates themself from talking with Margaret.

Agent Faraji is in the hallway. Their office is to the south, Klimp's is to the west, and Moira's is to the north. The front office is east.

A phone is ringing to the south.

They can go north, south, east or west.

>s
Agent Faraji is in their office. They pause and survey the scene. It's not much -- four white walls, grey industrial carpet. Margaret has helpfully assembled Faraji's desk and chair, though how sturdily is an open question. She also took the time to put up some of Agent Faraji's office decor -- their degree in Nonstandard Investigative Techniques, an original pencil drawing of the Pitfall snake by semi-acclaimed Washington DC artist Darius 5200, and a photo of their softball team. At the very least the wall coverings help compensate for the lack of windows. There's a disconnected landline on the desk. The office door is to the north, and there's a white metal door to the west.

Faraji mutters, "Where's my computer?"

A phone is ringing inside their desk.

They can go north or west.

>n
Agent Faraji is in the hallway. Their office is to the south, Klimp's is to the west, and Moira's is to the north. The front office is east.

A phone is ringing to the south.

They can go north, south, east or west.

>e
Agent Faraji is in the front office. It's really a small storefront done up to resemble an office. A store sales counter serves as a front desk, behind which are located shelves of office supplies and a row of drawers. There are also a couch and coffee table here creating a makeshift seating area. An old department store clothing rack serves as a coatrack. Photos on the walls picture the Bureau in better days. A stack of used and empty cardboard boxes sits in one corner.

The Bureau's latest office manager, Margaret is bustling around with unrestrained enthusiasm.

A phone is ringing not too far away.

Faraji can ask about the status of the computer.

They can go east, west or outside.

* * *

>q
Are you sure you want to quit?

* * *

>w
Just like in the store this once was, the door chimes as Faraji walks in.

Agent Faraji is in the front office. It's really a small storefront done up to resemble an office. A store sales counter serves as a front desk, behind which are located shelves of office supplies and a row of drawers. There are also a couch and coffee table here creating a makeshift seating area. An old department store clothing rack serves as a coatrack. Photos on the walls picture the Bureau in better days. A stack of used and empty cardboard boxes sits in one corner.

The Bureau's latest office manager, Margaret is bustling around with unrestrained enthusiasm, unpacking boxes and assembling an approximation of a respectable front office, all as if the Bureau isn't going to be shut down before the year is out. She sees Faraji and practically squeals. "Agent Faraji! I'm sorry -- Larch! How are you? I hope you don't mind -- I took the liberty of putting your desk together. I just love hex wrenches, don't you? Also, your new phone is here. I put it in your desk. Good timing! Now I just need you to give me your old phone so I can deactivate it."

Faraji hands Margaret their old phone. Margaret taps a few keys on her computer and says "There! All settled."

"Oh, good", Faraji says. "Our phone downgrades have arrived from our bureaucratic betters."

Faraji can go east, west or outside. 

A phone is ringing not too far away.

Faraji can go east, west or outside.

* * *

>sw
(first opening the pawn shop door)
"Cha-ching!" rings the electronic chime as Faraji steps into the store.

Agent Faraji is in Dave's pawn shop. This is more the seedy, gloomy stereotype of a pawn shop than the glitzy sanitized version of TV reality shows. The blinds in the windows are closed to only allow the barest slant of sunlight in, leaving the sickly fluorescent lights to illuminate the room. There is the distinct smell of cigar smoke. The glass counter is filled with a large collection of possibly valuable items. Behind it is an impressive array of firearms.

A man, presumably Dave, stands behind the main counter eyeing Faraji.

The pawn shop door closes.

Faraji can go northeast (to the south end of the strip mall parking lot) or outside (to the south end of the strip mall parking lot).

>ne
(first opening the pawn shop door)
Once again -- "Cha-ching!" -- as Faraji leaves the store.

Agent Faraji is at the south end of the strip mall parking lot. From here one can see just how humble BOSH's state has become: the office is to the west, between a pawn shop (to the southwest) and a run-down laundromat (to the northwest) and across from an automatic car wash. To the south is a swampy area separating the lot from the interstate. The parking lot continues north.

Their Hyundai is parked nearby.

The pawn shop door closes.

Faraji can go north, northwest, southwest (to Dave's pawn shop), west or inside.

>n
Faraji trudges to the other end of the parking lot. It's much like where they left.

Agent Faraji is at the north end of the strip mall parking lot. This end is no more auspicious than the other. A convenience store lies to the east. To the west is a military recruitment center. North of here the parking lot exits onto a busy road. There is a rusty sign by the road naming the shopping center: Park Place. South is BOSH headquarters, among other things.

Faraji can go south (to the south end of the strip mall parking lot), east or inside.

>e
Faraji is greeted by a blast of music as they enter the store.

Agent Faraji is in the Li'l Nectarine Convenience Store. Li'l Nectarine offers great service and low prices, or so they say. This one's cluttered aisles and sparse shelves could make one wonder if that's true. Behind the counter is the typical array of cigarettes and lottery tickets. Under the counter is a glass case containing various useful items.

The clerk, a scruffy man in his mid-twenties, is leaning against the counter, looking bored.

Faraji can go west (to the north end of the strip mall parking lot) or outside (to the north end of the strip mall parking lot).

>w
Faraji exits the store into the relative quiet of the nearby traffic.

Agent Faraji is at the north end of the strip mall parking lot. This end is no more auspicious than the other. A convenience store lies to the east. To the west is a military recruitment center. North of here the parking lot exits onto a busy road. There is a rusty sign by the road naming the shopping center: Park Place. South is BOSH headquarters, among other things.

Faraji can go south (to the south end of the strip mall parking lot), east (to Li'l Nectarine Convenience Store) or inside (to Li'l Nectarine Convenience Store).

* * *

>w
Just like in the store this once was, the door chimes as Faraji walks in.

Agent Faraji is in the front office. It's really a small storefront done up to resemble an office. A store sales counter serves as a front desk, behind which are located shelves of office supplies and a row of drawers. There are also a couch and coffee table here creating a makeshift seating area. An old department store clothing rack serves as a coatrack. Photos on the walls picture the Bureau in better days. A stack of used and empty cardboard boxes sits in one corner.

The Bureau's latest office manager, Margaret is bustling around with unrestrained enthusiasm, unpacking boxes and assembling an approximation of a respectable front office, all as if the Bureau isn't going to be shut down before the year is out. She sees Faraji and practically squeals. "Agent Faraji! I'm sorry -- Larch! How are you? I hope you don't mind -- I took the liberty of putting your desk together. I just love hex wrenches, don't you? Also, your new phone is here. I put it in your desk. Good timing! Now I just need you to give me your old phone so I can deactivate it."

Faraji hands Margaret their old phone. Margaret taps a few keys on her computer and says "There! All settled."

"Oh, good", Faraji says. "Our phone downgrades have arrived from our bureaucratic betters."

A phone is ringing not too far away.

>e
Faraji steps out of the office into the parking lot.

Agent Faraji is at the south end of the strip mall parking lot. From here one can see just how humble BOSH's state has become: the office is to the west, between a pawn shop (to the southwest) and a run-down laundromat (to the northwest) and across from an automatic car wash. To the south is a swampy area separating the lot from the interstate. The parking lot continues north.

Their Hyundai is parked nearby.

Faraji can go north, northwest, southwest, west or inside.

* * *

>rules
Rules tracing now switched on. Type "rules off" to switch it off again, or "rules all" to include even rules which do not apply.

[Rule "clear LPR rule" applies.]
[Rule "reset skip sounds rule" applies.]

* * *

>s
Faraji can't go that way.

A phone is ringing not too far away.

>w
Faraji extricates themself from talking with Margaret.

Agent Faraji is in the hallway. Their office is to the south, Klimp's is to the west, and Moira's is to the north. The front office is east.

A phone is ringing to the south.

* * *

>n
Agent Faraji is in the hallway. Their office is to the south, Klimp's is to the west, and Moira's is to the north. The front office is east.

A phone is ringing to the south.

Faraji can go north, south, east or west.

>e
Agent Faraji is in the front office. It's really a small storefront done up to resemble an office. A store sales counter serves as a front desk, behind which are located shelves of office supplies and a row of drawers. There are also a couch and coffee table here creating a makeshift seating area. An old department store clothing rack serves as a coatrack. Photos on the walls picture the Bureau in better days. A stack of used and empty cardboard boxes sits in one corner.

The Bureau's latest office manager, Margaret is bustling around with unrestrained enthusiasm.

A phone is ringing not too far away.

Faraji can go east, west or outside. They can ask about the status of the computer.

>rules
Rules tracing now switched on. Type "rules off" to switch it off again, or "rules all" to include even rules which do not apply.

[Rule "clear LPR rule" applies.]
[Rule "reset skip sounds rule" applies.]

* * *

>take boxes
Faraji picks up a couple of boxes and flattens them.

Margaret says, "Hey, what are you doing with those boxes, Agent Faraji? You don't have to worry about that -- I'll get them." She takes the flattened boxes from Faraji and hustles off.

A phone is ringing not too far away.

Margaret goes west.

Faraji can go east, west or outside.

>w
Agent Faraji is in the hallway. Their office is to the south, Klimp's is to the west, and Moira's is to the north. The front office is east.

Also here is Margaret.

A phone is ringing to the south.

Margaret goes south.

Faraji can go north, south, east or west.

>s
Agent Faraji is in their office. It's basically four white walls and grey carpet. There's a cheap desk and chair, and a disconnected phone on the desk. In lieu of windows, there are a few things on the wall: their degree in Nonstandard Investigative Techniques, a pencil drawing of the Pitfall snake, and a photo of their softball team. The office door is to the north, and there's a white metal door to the west.

Also here is Margaret.

A phone is ringing inside Faraji's desk.

Margaret unlocks the white metal door.

Faraji can go north or west. They can ask about the status of the computer.

>w
(first opening the white metal door)
Agent Faraji is in the back lot. This is a small area of asphalt between the building and a chain link fence looking in on an industrial property. A door to east leads into the BOSH offices, and one to the north enters the laundromat. There is a blue dumpster here.

A phone is ringing to the east.

Margaret arrives from the east.

Faraji can go north or east.

>lens
A phone is ringing to the east.

Margaret tosses the flattened boxes over the edge of the dumpster.

Faraji can go north, east or back.

>remove lenses
Faraji takes off the astral lenses.

A phone is ringing to the east.

Margaret goes east.

Faraji can go north or east.

>wear lenses
Faraji puts on the astral lenses.

A phone is ringing to the east.

The white metal door closes.

Faraji can go north, east or back.

>b
Agent Faraji is in the astral tunnel. It is featureless white, or what passes for white here. It bends "forth" to north.

Faraji can go north or forth.

>n
Agent Faraji is in the astral tunnel. It is featureless white, or what passes for white here. It bends south to "forth."

Faraji can go south or forth.

>f
Agent Faraji is in the laundromat back room. 

A strange sparkly white passage branches off in an impossible direction from here.

Faraji has discovered a hyperspatial tunnel! It leads in the hyperspatial direction of "back".
For help regarding hyperspace, enter HELP HYPERSPACE.

Wearing the astral lenses in fluorescent light is blinding. They quickly remove the glasses.

Faraji can go south, east or down.

>d
Agent Faraji is in the laundromat basement. 

Faraji can go south or up.

>s
Agent Faraji is in the back basement. 

Faraji can go north.

>l
Agent Faraji is in the back basement. 

Faraji can go north.

* * *

>w
Agent Faraji is in the hallway. Their office is to the south, Klimp's is to the west, and Moira's is to the north. The front office is east.

A phone is ringing to the south.

They can go north, south, east or west.

>s
Agent Faraji is in their office. It's basically four white walls and grey carpet. There's a cheap desk and chair, and a disconnected phone on the desk. In lieu of windows, there are a few things on the wall: their degree in Nonstandard Investigative Techniques, a pencil drawing of the Pitfall snake, and a photo of their softball team. The office door is to the north, and there's a white metal door to the west.

A phone is ringing inside their desk.

They can go north or west.

>open desk
They try to open the desk to answer the phone, but it seems to be locked. They sigh. "Margaret must have the key."

A phone is ringing inside their desk.

They can go north or west.

>n
Agent Faraji is in the hallway. Their office is to the south, Klimp's is to the west, and Moira's is to the north. The front office is east.

A phone is ringing to the south.

They can go north, south, east or west.

>e
Agent Faraji is in the front office. It's really a small storefront done up to resemble an office. A store sales counter serves as a front desk, behind which are located shelves of office supplies and a row of drawers. There are also a couch and coffee table here creating a makeshift seating area. An old department store clothing rack serves as a coatrack. Photos on the walls picture the Bureau in better days. A stack of used and empty cardboard boxes sits in one corner.

The Bureau's latest office manager, Margaret is bustling around with unrestrained enthusiasm.

A phone is ringing not too far away.

Faraji can go east, west or outside. They can ask about the whereabouts of the desk key or ask about the status of the computer.

>ask about the status of the computer
"Margaret", Faraji says, "what's up with my computer?"

"Oh, it got busted up during the move. I have it behind my desk -- you can see it if you want. We'll have to get you a new one."

A phone is ringing not too far away.

They can go east, west or outside. They can ask about the whereabouts of the desk key.

>i
Faraji is carrying:
  the Bureau credit card

A phone is ringing not too far away.

They can go east, west or outside. They can ask about the whereabouts of the desk key.

>drop card
Dropped.

A phone is ringing not too far away.

Faraji can go east, west or outside. They can ask about the whereabouts of the desk key.

>l
Agent Faraji is in the front office. It's really a small storefront done up to resemble an office. A store sales counter serves as a front desk, behind which are located shelves of office supplies and a row of drawers. There are also a couch and coffee table here creating a makeshift seating area. An old department store clothing rack serves as a coatrack. Photos on the walls picture the Bureau in better days. A stack of used and empty cardboard boxes sits in one corner.

The Bureau's latest office manager, Margaret is bustling around with unrestrained enthusiasm.

Also here is the Bureau credit card.

A phone is ringing not too far away.

Faraji can go east, west or outside. They can ask about the whereabouts of the desk key.

>take card
Taken.

A phone is ringing not too far away.

Faraji can go east, west or outside. They can ask about the whereabouts of the desk key.

>l
Agent Faraji is in the front office. It's really a small storefront done up to resemble an office. A store sales counter serves as a front desk, behind which are located shelves of office supplies and a row of drawers. There are also a couch and coffee table here creating a makeshift seating area. An old department store clothing rack serves as a coatrack. Photos on the walls picture the Bureau in better days. A stack of used and empty cardboard boxes sits in one corner.

The Bureau's latest office manager, Margaret is bustling around with unrestrained enthusiasm.

A phone is ringing not too far away.

Faraji can go east, west or outside. They can ask about the whereabouts of the desk key.

* * *

>n
Agent Faraji is in the hallway. Their office is to the south, Klimp's is to the west, and Moira's is to the north. The front office is east.

A phone is ringing to the south.

Faraji can go north, south, east or west.

>s
Agent Faraji is in their office. It's basically four white walls and grey carpet. There's a cheap desk and chair, and a disconnected phone on the desk. In lieu of windows, there are a few things on the wall: their degree in Nonstandard Investigative Techniques, a pencil drawing of the Pitfall snake, and a photo of their softball team. The office door is to the north, and there's a white metal door to the west.

A phone is ringing inside their desk.

Faraji can go north or west.

>open desk
They try to open the desk to answer the phone, but it seems to be locked. They sigh. "Margaret must have the key."

A phone is ringing inside their desk.

Faraji can go north or west.

>e
They can't go that way.

A phone is ringing inside their desk.

Faraji can go north or west.

>n
Agent Faraji is in the hallway. Their office is to the south, Klimp's is to the west, and Moira's is to the north. The front office is east.

A phone is ringing to the south.

Faraji can go north, south, east or west.

>e
Agent Faraji is in the front office. It's really a small storefront done up to resemble an office. A store sales counter serves as a front desk, behind which are located shelves of office supplies and a row of drawers. There are also a couch and coffee table here creating a makeshift seating area. An old department store clothing rack serves as a coatrack. Photos on the walls picture the Bureau in better days. A stack of used and empty cardboard boxes sits in one corner.

The Bureau's latest office manager, Margaret is bustling around with unrestrained enthusiasm.

A phone is ringing not too far away.

Faraji can go east, west or outside. They can ask about the whereabouts of the desk key or ask about the status of the computer.

>ask about status
"Margaret", Faraji says, "what's up with my computer?"

"Oh, it got busted up during the move. I have it behind my desk -- you can see it if you want. We'll have to get you a new one."

A phone is ringing not too far away.

Faraji can go east, west or outside. They can ask about the whereabouts of the desk key.

>look behind desk
There are a number of shelves of office supplies behind the desk. There is also a heating vent on the floor here.

Faraji finds their computer and pulls it out.

A phone is ringing not too far away.

Faraji can go east, west or outside. They can ask about the whereabouts of the desk key.

>x computer
Faraji's computer has been damaged beyond repair. But they do find a thumb drive and take it.

A phone is ringing not too far away.

They can remember finding the drive before.

Faraji can go east, west or outside. They can ask about the whereabouts of the desk key.

>remember finding the drive
Faraji remembers finding the drive in an ancient Onandaga root cellar on a farm in upstate New York. They have never been able to read it.

A phone is ringing not too far away.

Faraji can go east, west or outside. They can ask about the whereabouts of the desk key.

>memories
Faraji can remember finding the drive before.

A phone is ringing not too far away.

Faraji can go east, west or outside. They can ask about the whereabouts of the desk key.

>out
Faraji steps out of the office into the parking lot.

Agent Faraji is at the south end of the strip mall parking lot. From here one can see just how humble BOSH's state has become: the office is to the west, between a pawn shop (to the southwest) and a run-down laundromat (to the northwest) and across from an automatic car wash. To the south is a swampy area separating the lot from the interstate. The parking lot continues north.

Their Hyundai is parked nearby.

Faraji can go north, northwest, southwest, west or inside.

>in
Agent Faraji is in the front office. It's really a small storefront done up to resemble an office. A store sales counter serves as a front desk, behind which are located shelves of office supplies and a row of drawers. There are also a couch and coffee table here creating a makeshift seating area. An old department store clothing rack serves as a coatrack. Photos on the walls picture the Bureau in better days. A stack of used and empty cardboard boxes sits in one corner.

The Bureau's latest office manager, Margaret is bustling around with unrestrained enthusiasm.

Also here is Faraji's computer.

A phone is ringing not too far away.

Faraji can go east, west or outside. They can ask about the whereabouts of the desk key.

>w
Agent Faraji is in the hallway. Their office is to the south, Klimp's is to the west, and Moira's is to the north. The front office is east.

A phone is ringing to the south.

Faraji can go north, south, east or west.

>n
(first opening Moira's door)
It seems to be locked.

A phone is ringing to the south.

Faraji can go north, south, east or west.

>w
(first opening Klimp's door)
It seems to be locked.

A phone is ringing to the south.

Faraji can go north, south, east or west.

>s
Agent Faraji is in their office. It's basically four white walls and grey carpet. There's a cheap desk and chair, and a disconnected phone on the desk. In lieu of windows, there are a few things on the wall: their degree in Nonstandard Investigative Techniques, a pencil drawing of the Pitfall snake, and a photo of their softball team. The office door is to the north, and there's a white metal door to the west.

A phone is ringing inside their desk.

Faraji can go north or west.

>w
(first opening the white metal door)
It seems to be locked.

A phone is ringing inside their desk.

Faraji can go north or west.

>n
Agent Faraji is in the hallway. Their office is to the south, Klimp's is to the west, and Moira's is to the north. The front office is east.

A phone is ringing to the south.

Faraji can go north, south, east or west.

>e
Agent Faraji is in the front office. It's really a small storefront done up to resemble an office. A store sales counter serves as a front desk, behind which are located shelves of office supplies and a row of drawers. There are also a couch and coffee table here creating a makeshift seating area. An old department store clothing rack serves as a coatrack. Photos on the walls picture the Bureau in better days. A stack of used and empty cardboard boxes sits in one corner.

The Bureau's latest office manager, Margaret is bustling around with unrestrained enthusiasm.

Also here is Faraji's computer.

A phone is ringing not too far away.

Faraji can go east, west or outside. They can ask about the whereabouts of the desk key or ask to unlock the backdoor.

>e
Agent Faraji is at the south end of the strip mall parking lot. From here one can see just how humble BOSH's state has become: the office is to the west, between a pawn shop (to the southwest) and a run-down laundromat (to the northwest) and across from an automatic car wash. To the south is a swampy area separating the lot from the interstate. The parking lot continues north.

Their Hyundai is parked nearby.

Faraji can go north, northwest, southwest, west or inside.

>sw
(first opening the pawn shop door)
"Cha-ching!" rings the electronic chime as Faraji steps into the store.

Agent Faraji is in Dave's pawn shop. This is more the seedy, gloomy stereotype of a pawn shop than the glitzy sanitized version of TV reality shows. The blinds in the windows are closed to only allow the barest slant of sunlight in, leaving the sickly fluorescent lights to illuminate the room. There is the distinct smell of cigar smoke. The glass counter is filled with a large collection of possibly valuable items. Behind it is an impressive array of firearms.

A man, presumably Dave, stands behind the main counter eyeing Faraji.

The pawn shop door closes.

Faraji can go northeast or outside.

>nw
Faraji can't go that way.

Faraji can go northeast or outside.

>w
Faraji can't go that way.

Faraji can go northeast or outside.

>ne
(first opening the pawn shop door)
Once again -- "Cha-ching!" -- as Faraji leaves the store.

Agent Faraji is at the south end of the strip mall parking lot. From here one can see just how humble BOSH's state has become: the office is to the west, between a pawn shop (to the southwest) and a run-down laundromat (to the northwest) and across from an automatic car wash. To the south is a swampy area separating the lot from the interstate. The parking lot continues north.

Their Hyundai is parked nearby.

The pawn shop door closes.

Faraji can go north, northwest, southwest, west or inside.

>w
Agent Faraji is in the front office. It's really a small storefront done up to resemble an office. A store sales counter serves as a front desk, behind which are located shelves of office supplies and a row of drawers. There are also a couch and coffee table here creating a makeshift seating area. An old department store clothing rack serves as a coatrack. Photos on the walls picture the Bureau in better days. A stack of used and empty cardboard boxes sits in one corner.

The Bureau's latest office manager, Margaret is bustling around with unrestrained enthusiasm.

Also here is Faraji's computer.

A phone is ringing not too far away.

Faraji can go east, west or outside. They can ask about the whereabouts of the desk key or ask to unlock the backdoor.

>x vent
A typical air register with a grill which one would hope would stop things like, say, a hex wrench from falling through. It's set in the floor behind the front desk. The vent is held closed by four screws.

In the heating vent is a hex wrench.

A phone is ringing not too far away.

Faraji can go east, west or outside. They can ask about the whereabouts of the desk key, ask for a screwdriver or ask to unlock the backdoor.

>e
Agent Faraji is at the south end of the strip mall parking lot. From here one can see just how humble BOSH's state has become: the office is to the west, between a pawn shop (to the southwest) and a run-down laundromat (to the northwest) and across from an automatic car wash. To the south is a swampy area separating the lot from the interstate. The parking lot continues north.

Their Hyundai is parked nearby.

Faraji can go north, northwest, southwest, west or inside.

>sw
(first opening the pawn shop door)
Agent Faraji is in Dave's pawn shop. This is more the seedy, gloomy stereotype of a pawn shop than the glitzy sanitized version of TV reality shows. The blinds in the windows are closed to only allow the barest slant of sunlight in, leaving the sickly fluorescent lights to illuminate the room. There is the distinct smell of cigar smoke. The glass counter is filled with a large collection of possibly valuable items. Behind it is an impressive array of firearms.

A man, presumably Dave, stands behind the main counter eyeing Faraji.

The pawn shop door closes.

Faraji can go northeast or outside. They can ask for a screwdriver.

>ask for screwdriver
Faraji leans on the counter. "Hey, do you have a screwdriver? Can't find mine and I really need one."

The man shakes his head and says, "Sorry, miss. I had one, but the guy who runs the laundromat borrowed it and didn't bring it back."

Faraji can go northeast or outside. They can ask about the laundromat owner.

>ask about owner
Faraji nods. "Okay, then, how do I get in touch with this laundromat guy?"

"Well, that's a tricky one. Laundromat's been closed for almost two weeks now, since the owner just split for some reason he didn't bother to share. Not likely to get ahold of him. If you're not averse to a little trespassing, though, see if you come across a watch. Another thing he borrowed."

Faraji can go northeast or outside.

>out
Agent Faraji is at the south end of the strip mall parking lot. From here one can see just how humble BOSH's state has become: the office is to the west, between a pawn shop (to the southwest) and a run-down laundromat (to the northwest) and across from an automatic car wash. To the south is a swampy area separating the lot from the interstate. The parking lot continues north.

Their Hyundai is parked nearby.

Faraji can go north, northwest, southwest, west or inside.

>in
Agent Faraji is in the front office. It's really a small storefront done up to resemble an office. A store sales counter serves as a front desk, behind which are located shelves of office supplies and a row of drawers. There are also a couch and coffee table here creating a makeshift seating area. An old department store clothing rack serves as a coatrack. Photos on the walls picture the Bureau in better days. A stack of used and empty cardboard boxes sits in one corner.

The Bureau's latest office manager, Margaret is bustling around with unrestrained enthusiasm.

Also here is Faraji's computer.

A phone is ringing not too far away.

Faraji can go east, west or outside. They can ask about the whereabouts of the desk key, ask for a screwdriver or ask to unlock the backdoor.

>x computer
Faraji's computer has been damaged beyond repair.

A phone is ringing not too far away.

Faraji can go east, west or outside. They can ask about the whereabouts of the desk key, ask for a screwdriver or ask to unlock the backdoor.

>ask about key
Faraji says, "Hey Margaret, do you know anything about my desk key?"

"Sure I do -- I put it in your desk." She furrows her brow. "What's the matter?"

A phone is ringing not too far away.

Faraji can go east, west or outside. They can ask for a screwdriver or ask to unlock the backdoor.

>w
Agent Faraji is in the hallway. Their office is to the south, Klimp's is to the west, and Moira's is to the north. The front office is east.

A phone is ringing to the south.

Faraji can go north, south, east or west.

>s
Agent Faraji is in their office. It's basically four white walls and grey carpet. There's a cheap desk and chair, and a disconnected phone on the desk. In lieu of windows, there are a few things on the wall: their degree in Nonstandard Investigative Techniques, a pencil drawing of the Pitfall snake, and a photo of their softball team. The office door is to the north, and there's a white metal door to the west.

A phone is ringing inside their desk.

Faraji can go north or west.

>x desk
The desk is a cheap DIY piece held together with hex screws. It has a single drawer which is closed.

A phone is ringing inside their desk.

Faraji can go north or west.

>n
Agent Faraji is in the hallway. Their office is to the south, Klimp's is to the west, and Moira's is to the north. The front office is east.

A phone is ringing to the south.

Faraji can go north, south, east or west.

>e
Agent Faraji is in the front office. It's really a small storefront done up to resemble an office. A store sales counter serves as a front desk, behind which are located shelves of office supplies and a row of drawers. There are also a couch and coffee table here creating a makeshift seating area. An old department store clothing rack serves as a coatrack. Photos on the walls picture the Bureau in better days. A stack of used and empty cardboard boxes sits in one corner.

The Bureau's latest office manager, Margaret is bustling around with unrestrained enthusiasm.

Also here is Faraji's computer.

A phone is ringing not too far away.

Faraji can go east, west or outside. They can ask for the hex wrench, ask for a screwdriver or ask to unlock the backdoor.

>ask about key
Faraji says, "Do you happen to have the hex wrench from putting together my desk?"

"Well, I did, but I dropped it down a heating vent behind my desk."

A phone is ringing not too far away.

Faraji can go east, west or outside. They can ask for a screwdriver or ask to unlock the backdoor.

>x veny
There's nothing like that nearby.

>x vent
A typical air register with a grill which one would hope would stop things like, say, a hex wrench from falling through. It's set in the floor behind the front desk. The vent is held closed by four screws.

In the heating vent is a hex wrench.

A phone is ringing not too far away.

Faraji can go east, west or outside. They can ask for a screwdriver or ask to unlock the backdoor.

>take hex
Faraji's fingers won't fit through the openings in the vent. They"ll have to open it first.

A phone is ringing not too far away.

Faraji can go east, west or outside. They can ask for a screwdriver or ask to unlock the backdoor.

>open vent
The vent is held closed by four screws.

A phone is ringing not too far away.

Faraji can go east, west or outside. They can ask for a screwdriver or ask to unlock the backdoor.

>take screws
Those seem to be a part of the heating vent.

A phone is ringing not too far away.

Faraji can go east, west or outside. They can ask for a screwdriver or ask to unlock the backdoor.

>ask to unlock
Faraji asks, "Could you unlock the back door, Margaret?"

"Sorry, too busy right now. What do you want back there anyway? There's only a dumpster." She pauses for a moment and mutters to herself. "Which reminds me, I need to get these boxes broken down."

A phone is ringing not too far away.

Faraji can go east, west or outside. They can ask for a screwdriver.

>x boxes
There is a stack of boxes in the corner.

A phone is ringing not too far away.

Faraji can go east, west or outside. They can ask for a screwdriver.

>take boxes
Faraji picks up a couple of boxes and flattens them.

Margaret says, "Hey, what are you doing with those boxes, Agent Faraji? You don't have to worry about that -- I'll get them." She takes the flattened boxes from Faraji and hustles off.

A phone is ringing not too far away.

Margaret goes west.

Faraji can go east, west or outside.

* * *

>w
Agent Faraji is in the hallway. Their office is to the south, Klimp's is to the west, and Moira's is to the north. The front office is east.

Also here is Margaret.

A phone is ringing to the south.

Margaret goes south.

Faraji can go north, south, east or west.

>s
Agent Faraji is in their office. It's basically four white walls and grey carpet. There's a cheap desk and chair, and a disconnected phone on the desk. In lieu of windows, there are a few things on the wall: their degree in Nonstandard Investigative Techniques, a pencil drawing of the Pitfall snake, and a photo of their softball team. The office door is to the north, and there's a white metal door to the west.

Also here is Margaret.

A phone is ringing inside Faraji's desk.

Margaret unlocks the white metal door.

Faraji can go north or west. They can ask for a screwdriver.

>w
(first opening the white metal door)
Agent Faraji is in the back lot. This is a small area of asphalt between the building and a chain link fence looking in on an industrial property. A door to east leads into the BOSH offices, and one to the north enters the laundromat. There is a blue dumpster here.

A phone is ringing to the east.

Margaret arrives from the east.

Faraji can go north, east or back.

* * *

>open desk
They try to open the desk to answer the phone, but it seems to be locked. They sigh. "Margaret must have the key."

A phone is ringing inside their desk.

>n
Agent Faraji is in the hallway. Their office is to the south, Klimp's is to the west, and Moira's is to the north. The front office is east.

A phone is ringing to the south.

* * *

>w
(first opening the white metal door)
It seems to be locked.

A phone is ringing inside their desk.

Faraji can go north (to the hallway) or west.

>e
They can't go that way.

A phone is ringing inside their desk.

Faraji can go north or west.

* * *

>n
Agent Faraji is in the hallway. Their office is to the south, Klimp's is to the west, and Moira's is to the north. The front office is east.

A phone is ringing to the south.

Faraji can go north, south, east or west.

>e
Agent Faraji is in the front office. It's really a small storefront done up to resemble an office. A store sales counter serves as a front desk, behind which are located shelves of office supplies and a row of drawers. There are also a couch and coffee table here creating a makeshift seating area. An old department store clothing rack serves as a coatrack. Photos on the walls picture the Bureau in better days. A stack of used and empty cardboard boxes sits in one corner.

The Bureau's latest office manager, Margaret is bustling around with unrestrained enthusiasm.

A phone is ringing not too far away.

Faraji can go east, west or outside. They can ask about the status of the computer or ask to unlock the backdoor.

>e
Faraji steps out of the office into the parking lot.

Agent Faraji is at the south end of the strip mall parking lot. From here one can see just how humble BOSH's state has become: the office is to the west, between a pawn shop (to the southwest) and a run-down laundromat (to the northwest) and across from an automatic car wash. To the south is a swampy area separating the lot from the interstate. The parking lot continues north.

Their Hyundai is parked nearby.

Faraji can go north, northwest, southwest, west or inside.

>exits
The obvious exits are north, northwest, southwest, west (to the front office) and inside (to the front office).

(Use EXITS ON to enable the status line exit lister and EXITS OFF to turn it off.)

* * *

>w
(first opening the white metal door)
It seems to be locked.

A phone is ringing inside their desk.

Faraji can go north (to the hallway) or west.

>n
Agent Faraji is in the hallway. Their office is to the south, Klimp's is to the west, and Moira's is to the north. The front office is east.

A phone is ringing to the south.

Faraji can go north, south (to their office), east (to the front office) or west.

>e
Agent Faraji is in the front office. It's really a small storefront done up to resemble an office. A store sales counter serves as a front desk, behind which are located shelves of office supplies and a row of drawers. There are also a couch and coffee table here creating a makeshift seating area. An old department store clothing rack serves as a coatrack. Photos on the walls picture the Bureau in better days. A stack of used and empty cardboard boxes sits in one corner.

The Bureau's latest office manager, Margaret is bustling around with unrestrained enthusiasm.

A phone is ringing not too far away.

Faraji can go east (to the south end of the strip mall parking lot), west (to the hallway) or outside (to the south end of the strip mall parking lot). They can ask about the status of the computer or ask to unlock the backdoor.

>e
Faraji steps out of the office into the parking lot.

Agent Faraji is at the south end of the strip mall parking lot. From here one can see just how humble BOSH's state has become: the office is to the west, between a pawn shop (to the southwest) and a run-down laundromat (to the northwest) and across from an automatic car wash. To the south is a swampy area separating the lot from the interstate. The parking lot continues north.

Their Hyundai is parked nearby.

Faraji can go north, northwest, southwest, west (to the front office) or inside (to the front office).

>n
Faraji trudges to the other end of the parking lot. It's much like where they left.

Agent Faraji is at the north end of the strip mall parking lot. This end is no more auspicious than the other. A convenience store lies to the east. To the west is a military recruitment center. North of here the parking lot exits onto a busy road. There is a rusty sign by the road naming the shopping center: Park Place. South is BOSH headquarters, among other things.

Faraji can go south (to the south end of the strip mall parking lot), east or inside.

>in
Faraji is greeted by a blast of music as they enter the store.

Agent Faraji is in the Li'l Nectarine Convenience Store. Li'l Nectarine offers great service and low prices, or so they say. This one's cluttered aisles and sparse shelves could make one wonder if that's true. Behind the counter is the typical array of cigarettes and lottery tickets. Under the counter is a glass case containing various useful items.

The clerk, a scruffy man in his mid-twenties, is leaning against the counter, looking bored.

Faraji can go west (to the north end of the strip mall parking lot) or outside (to the north end of the strip mall parking lot).

>w
Faraji exits the store into the relative quiet of the nearby traffic.

Agent Faraji is at the north end of the strip mall parking lot. This end is no more auspicious than the other. A convenience store lies to the east. To the west is a military recruitment center. North of here the parking lot exits onto a busy road. There is a rusty sign by the road naming the shopping center: Park Place. South is BOSH headquarters, among other things.

Faraji can go south (to the south end of the strip mall parking lot), east (to the li'l nectarine convenience store) or inside (to the li'l nectarine convenience store).

>n
Faraji has things to do here.

Faraji can go south (to the south end of the strip mall parking lot), east (to the li'l nectarine convenience store) or inside (to the li'l nectarine convenience store).

>s
Faraji walks back to the south end of the parking lot.

Agent Faraji is at the south end of the strip mall parking lot. From here one can see just how humble BOSH's state has become: the office is to the west, between a pawn shop (to the southwest) and a run-down laundromat (to the northwest) and across from an automatic car wash. To the south is a swampy area separating the lot from the interstate. The parking lot continues north.

Their Hyundai is parked nearby.

Faraji can go north (to the north end of the strip mall parking lot), northwest, southwest, west (to the front office) or inside (to the front office).

>sw
(first opening the pawn shop door)
"Cha-ching!" rings the electronic chime as Faraji steps into the store.

Agent Faraji is in Dave's pawn shop. This is more the seedy, gloomy stereotype of a pawn shop than the glitzy sanitized version of TV reality shows. The blinds in the windows are closed to only allow the barest slant of sunlight in, leaving the sickly fluorescent lights to illuminate the room. There is the distinct smell of cigar smoke. The glass counter is filled with a large collection of possibly valuable items. Behind it is an impressive array of firearms.

A man, presumably Dave, stands behind the main counter eyeing Faraji.

The pawn shop door closes.

Faraji can go northeast (to the south end of the strip mall parking lot) or outside (to the south end of the strip mall parking lot).

>ne
(first opening the pawn shop door)
Once again -- "Cha-ching!" -- as Faraji leaves the store.

Agent Faraji is at the south end of the strip mall parking lot. From here one can see just how humble BOSH's state has become: the office is to the west, between a pawn shop (to the southwest) and a run-down laundromat (to the northwest) and across from an automatic car wash. To the south is a swampy area separating the lot from the interstate. The parking lot continues north.

Their Hyundai is parked nearby.

The pawn shop door closes.

Faraji can go north (to the north end of the strip mall parking lot), northwest, southwest (to dave's pawn shop), west (to the front office) or inside (to the front office).

>nw
A sign on the laundromat door says "Closed for renovations".

Faraji can go north (to the north end of the strip mall parking lot), northwest, southwest (to dave's pawn shop), west (to the front office) or inside (to the front office).

* * *

>x bosh
Faraji gazes stoically at the sad little storefront that is the new BOSH office. The sign from the previous tenant is still up: "Angel's Department Store". Through the front window can be seen Margaret, in her usual manic work mode.

>x sign
Which do you mean, the department store sign, the laundromat sign or the flashing neon sign?

>department
It's adorned with a pair of angel's wings.

>x pawn shop
Which do you mean, the pawn shop door or Dave's pawn shop?

>neon
I only understood you as far as wanting to examine the flashing neon sign.

>neon
I'm not sure what you're trying to say. I might just not recognize the words you're using.

>x neon
Its flash rate is just a bit over the threshold of irritating.

>x laundromat door
It's a typical glass door. Taped to it is a sign that says "Closed for renovations".

>open laundromat door
(first unlocking the laundromat door)
Faraji lacks a key that fits the laundromat door.

* * *

>x pawn shop
Which do you mean, the pawn shop door or Dave's pawn shop?

>trace 5
[Parser tracing set to level 5.]

* * *

>rules off
[ "rules" rules / "off" off ]
[Parsing for the verb 'rules' (4 lines)]

[line 0 * -> RulesOn]
 [line 0 token 1 word 2 : END]

[line 1 * 'all' -> RulesAll]
[line rejected for not ending with correct preposition]

[line 2 * 'on' -> RulesOn]
[line rejected for not ending with correct preposition]

[line 3 * 'off' -> RulesOff]
 [line 3 token 1 word 2 : 'off']
  [token resulted in success]
 [line 3 token 2 word 3 : END]
[Line successfully parsed]
Rules tracing now switched off. Type "rules" to switch it on again.

* * *

>trace off
[ "trace" trace / "off" off ]
[Parsing for the verb 'trace' (4 lines)]

[line 0 * -> TraceOn]
 [line 0 token 1 word 2 : END]

[line 1 * number -> TraceLevel]
 [line 1 token 1 word 2 : number]
  [token resulted in failure with error type 3]

[line 2 * 'on' -> TraceOn]
[line rejected for not ending with correct preposition]

[line 3 * 'off' -> TraceOff]
 [line 3 token 1 word 2 : 'off']
  [token resulted in success]
 [line 3 token 2 word 3 : END]
[Line successfully parsed]
Trace off.

>showme dave's pawn shop
Dave's pawn shop - unenterable room
    flashing neon sign (part of Dave's pawn shop)
location: in the south end of the strip mall parking lot
singular-named, proper-named, unmarked for special listing; unlit, inedible, fixed in place, scenery, neuter, seen, familiar, quiet, background; enterable
list grouping key: none
printed name: "Dave's pawn shop"
printed plural name: "unenterable rooms"
indefinite article: none
most recent reference: nominal
third singular pronoun: It-pronoun
summary: none
description: "Faraji observes the pawn shop with obvious distaste. The flashing neon sign in the window advertises "Cash for gold!""
initial appearance: none
dark description: none
hearability: very loud
volume: 0.0
price: $0
behind description: none
third-plural-pronoun: They-pronoun
possessive: none
portrait: Figure Null
Dave's pawn shop - room
    pawn-light - light source
    Dave - man
singular-named, proper-named, unmarked for special listing; lighted, unvisited, fully lit
list grouping key: none
printed name: "Dave's pawn shop"
printed plural name: none
indefinite article: none
most recent reference: nominal
third singular pronoun: It-pronoun
summary: none
description: "This is more the seedy, gloomy stereotype of a pawn shop than the glitzy sanitized version of TV reality shows. The blinds in the windows are closed to only allow the barest slant of sunlight in, leaving the sickly fluorescent lights to illuminate the room. There is the distinct smell of cigar smoke. The glass counter is filled with a large collection of possibly valuable items. Behind it is an impressive array of firearms."
map region: Swamp Park
dark description: none
reception: true
preposition: "in"
room condition: indoors

>showme pawn shop
Dave's pawn shop - unenterable room
    flashing neon sign (part of Dave's pawn shop)
location: in the south end of the strip mall parking lot
singular-named, proper-named, unmarked for special listing; unlit, inedible, fixed in place, scenery, neuter, seen, familiar, quiet, background; enterable
list grouping key: none
printed name: "Dave's pawn shop"
printed plural name: "unenterable rooms"
indefinite article: none
most recent reference: nominal
third singular pronoun: It-pronoun
summary: none
description: "Faraji observes the pawn shop with obvious distaste. The flashing neon sign in the window advertises "Cash for gold!""
initial appearance: none
dark description: none
hearability: very loud
volume: 0.0
price: $0
behind description: none
third-plural-pronoun: They-pronoun
possessive: none
portrait: Figure Null
pawn shop door - shop door
location: in the south end of the strip mall parking lot
singular-named, improper-named, unmarked for special listing; unlit, inedible, fixed in place, scenery, neuter, seen, familiar, quiet, background; closed, openable, lockable, unlocked; front-openable, back-openable, front-closable, back-closable, front-locks-the-back, front-locks-the-front, back-locks-the-back, back-locks-the-front, auto-closable
list grouping key: none
printed name: "pawn shop door"
printed plural name: "shop doors"
indefinite article: none
most recent reference: nominal
third singular pronoun: It-pronoun
summary: none
description: "It's a typical glass door. The light within is too dim to see much."
initial appearance: none
dark description: none
hearability: very loud
volume: 0.0
price: $0
behind description: none
third-plural-pronoun: They-pronoun
possessive: none
portrait: Figure Null
other side: Dave's pawn shop
frontside: south end of the strip mall parking lot
close delay: 0
time lock delay: 0
front description: none
back description: none
description policy: describe-always
lock countdown: -1
close countdown: -1
Dave's pawn shop - room
    pawn-light - light source
    Dave - man
singular-named, proper-named, unmarked for special listing; lighted, unvisited, fully lit
list grouping key: none
printed name: "Dave's pawn shop"
printed plural name: none
indefinite article: none
most recent reference: nominal
third singular pronoun: It-pronoun
summary: none
description: "This is more the seedy, gloomy stereotype of a pawn shop than the glitzy sanitized version of TV reality shows. The blinds in the windows are closed to only allow the barest slant of sunlight in, leaving the sickly fluorescent lights to illuminate the room. There is the distinct smell of cigar smoke. The glass counter is filled with a large collection of possibly valuable items. Behind it is an impressive array of firearms."
map region: Swamp Park
dark description: none
reception: true
preposition: "in"
room condition: indoors

>showme pawn shop door
pawn shop door - shop door
location: in the south end of the strip mall parking lot
singular-named, improper-named, unmarked for special listing; unlit, inedible, fixed in place, scenery, neuter, seen, familiar, quiet, background; closed, openable, lockable, unlocked; front-openable, back-openable, front-closable, back-closable, front-locks-the-back, front-locks-the-front, back-locks-the-back, back-locks-the-front, auto-closable
list grouping key: none
printed name: "pawn shop door"
printed plural name: "shop doors"
indefinite article: none
most recent reference: nominal
third singular pronoun: It-pronoun
summary: none
description: "It's a typical glass door. The light within is too dim to see much."
initial appearance: none
dark description: none
hearability: very loud
volume: 0.0
price: $0
behind description: none
third-plural-pronoun: They-pronoun
possessive: none
portrait: Figure Null
other side: Dave's pawn shop
frontside: south end of the strip mall parking lot
close delay: 0
time lock delay: 0
front description: none
back description: none
description policy: describe-always
lock countdown: -1
close countdown: -1

* * *

>z
Faraji stands around and waits.

Faraji can go north, northwest, southwest, west or inside.

>z
Faraji stands around and waits.

Faraji can go north, northwest, southwest, west or inside.

>rules
Rules tracing now switched on. Type "rules off" to switch it off again, or "rules all" to include even rules which do not apply.

[Rule "clear LPR rule" applies.]
[Rule "reset skip sounds rule" applies.]