As an agent of the Bureau of Strange Happenings (BOSH), it is Agent Larch Faraji's job to investigate unexplained phenomena throughout the United States and its territories. Recently, however, business hasn't been good. Once a bustling office with a dozen Agents, the Bureau's been reduced to just three: Faraji, Moira Zin, and Chief Huffton Klimp. The Bureau's expansive and well-appointed office suite was taken over by the State Department Book Club, and now the agents are consigned to a tiny suite in a strip mall in the remote D.C. suburb of Swamp Park, Maryland.

The reason? The venomous Senator Savra, whose crusade against all things he considers unwholesome is the scourge of Washington. To him, BOSH is nothing more than the devil's megaphone, giving credence to Satan's lies by giving them a hearing. Now Savra is at it again, threatening to cut BOSH entirely from next year's Federal budget.

But for now, today is move-in day at the bureau.

We open on a decrepit strip mall just as an aging Hyundai pulls into the potholed parking lot. Agent Faraji steps out of the car. They survey the area and wrinkle their nose.

The Bureau of Strange Happenings
An Interactive Phenomenon by Phil Riley
Release 1 / Serial number 230620 / Inform 7 build 6M62 (I6/v6.34 lib 6/12N) SD

Agent Faraji is at the south end of the strip mall parking lot. From here one can see just how humble BOSH's state has become: the office is to the west, between a pawn shop (to the southwest) and a run-down laundromat (to the northwest) and across from an automatic car wash. To the south is a swampy area separating the lot from the interstate. The parking lot continues north.

Their Hyundai is parked nearby.

>2
Agent Goldberg is at the south end of the strip mall parking lot. From here one can see just how humble BOSH's state has become: the office is to the west, between a pawn shop (to the southwest) and a run-down laundromat (to the northwest) and across from an automatic car wash. To the south is a swampy area separating the lot from the interstate. The parking lot continues north.

Her Hyundai is parked nearby.

>3
I'm not sure what you're trying to say. I might just not recognize the words you're using.

>w
Just like in the store this once was, the door chimes as Faraji walks in.

Agent Faraji is in the front office. It's really a small storefront done up to resemble an office. A store sales counter serves as a front desk, behind which are located shelves of office supplies and a row of drawers. There are also a couch and coffee table here creating a makeshift seating area. An old department store clothing rack serves as a coatrack. Photos on the walls picture the Bureau in better days. A stack of used and empty cardboard boxes sits in one corner.

The Bureau's latest office manager, Margaret is bustling around with unrestrained enthusiasm, unpacking boxes and assembling an approximation of a respectable front office, all as if the Bureau isn't going to be shut down before the year is out. She sees Faraji and practically squeals. "Agent Faraji! I'm sorry -- Larch! How are you? I hope you don't mind -- I took the liberty of putting your desk together. I just love hex wrenches, don't you? Also, your new phone is here. I put it in your desk. Now I just need you to give me your old phone so I can deactivate it."

Faraji hands Margaret their old phone. Margaret taps a few keys on her computer and says "There! All settled."

"Oh, good", Faraji says. "Our phone downgrades have arrived from our bureaucratic betters."

A phone is ringing somewhere else not too far away.

Faraji can ask about the phone exchange.

* * *

>2
Agent Goldberg is at the south end of the strip mall parking lot. From here one can see just how humble BOSH's state has become: the office is to the west, between a pawn shop (to the southwest) and a run-down laundromat (to the northwest) and across from an automatic car wash. To the south is a swampy area separating the lot from the interstate. The parking lot continues north.

Her Hyundai is parked nearby.

>enter office
Just like in the store this once was, the door chimes as Goldberg walks in.

Agent Goldberg is in the front office. It's really a small storefront done up to resemble an office. A store sales counter serves as a front desk, behind which are located shelves of office supplies and a row of drawers. There are also a couch and coffee table here creating a makeshift seating area. An old department store clothing rack serves as a coatrack. Photos on the walls picture the Bureau in better days. A stack of used and empty cardboard boxes sits in one corner.

The Bureau's latest office manager, Margaret is bustling around with unrestrained enthusiasm, unpacking boxes and assembling an approximation of a respectable front office, all as if the Bureau isn't going to be shut down before the year is out. She sees Goldberg and practically squeals. "Agent Goldberg! I'm sorry -- Petula! How are you? I hope you don't mind -- I took the liberty of putting your desk together. I just love hex wrenches, don't you? Also, your new phone is here. I put it in your desk. Good timing! Now I just need you to give me your old phone so I can deactivate it."

Goldberg hands Margaret her old phone. Margaret taps a few keys on her computer and says "There! All settled."

"Oh, good", Goldberg says. "Our phone downgrades have arrived from our bureaucratic betters."

A phone is ringing not too far away.

>answer phone
There's nothing like that nearby.

>examine photos
There's nothing like that nearby.

>search drawers
Goldberg finds nothing of interest.

A phone is ringing not too far away.

>GO TOWARDS THE RINGING PHONE.
There's nothing like that nearby.

>look around
There's nothing like that nearby.

>look
Agent Goldberg is in the front office. It's really a small storefront done up to resemble an office. A store sales counter serves as a front desk, behind which are located shelves of office supplies and a row of drawers. There are also a couch and coffee table here creating a makeshift seating area. An old department store clothing rack serves as a coatrack. Photos on the walls picture the Bureau in better days. A stack of used and empty cardboard boxes sits in one corner.

The Bureau's latest office manager, Margaret is bustling around with unrestrained enthusiasm.

A phone is ringing not too far away.

>e
Goldberg steps out of the office into the parking lot.

Agent Goldberg is at the south end of the strip mall parking lot. From here one can see just how humble BOSH's state has become: the office is to the west, between a pawn shop (to the southwest) and a run-down laundromat (to the northwest) and across from an automatic car wash. To the south is a swampy area separating the lot from the interstate. The parking lot continues north.

Her Hyundai is parked nearby.

>n
Goldberg trudges to the other end of the parking lot. It's much like where she left.

Agent Goldberg is at the north end of the strip mall parking lot. This end is no more auspicious than the other. A convenience store lies to the east. To the west is a military recruitment center. North of here the parking lot exits onto a busy road. There is a rusty sign by the road naming the shopping center: Park Place. South is BOSH headquarters, among other things.

>ENTER CONVENIENCE STORE
Goldberg is greeted by a blast of music as she enters the store.

Agent Goldberg is in the Li'l Nectarine Convenience Store. Li'l Nectarine offers great service and low prices, or so they say. This one's cluttered aisles and sparse shelves could make one wonder if that's true. Behind the counter is the typical array of cigarettes and lottery tickets. Under the counter is a glass case containing various useful items.

The clerk, a scruffy man in his mid-twenties, is leaning against the counter, looking bored.

>approach clerk
I'm not sure what you're trying to say. I might just not recognize the words you're using.

>EXAMINE GLASS CASE
In the glass case are a flashlight, a red screwdriver, a laptop computer and some wireless earbuds.

>take flashlight
The glass case isn't open.

>ASK CLERK TO OPEN THE GLASS CASE
I'm not sure what you're trying to say. I might just not recognize the words you're using.

>talk to clerk
Goldberg is already talking to the store clerk.

>clerk, open case
The store clerk has better things to do.

>USE RED SCREWDRIVER ON GLASS CASE
I'm not sure what you're trying to say. I might just not recognize the words you're using.

>examine counter
The counter is arrayed with displays of CBD oil, antacids, and the like.

>examine displays
There's nothing like that nearby.

>ASK CLERK FOR FLASHLIGHT
That doesn't seem to be a topic of conversation at the moment.

>ASK CLERK ABOUT FLASHLIGHT
That doesn't seem to be a topic of conversation at the moment.

>look
Agent Goldberg is in the Li'l Nectarine Convenience Store. Li'l Nectarine offers great service and low prices, or so they say. This one's cluttered aisles and sparse shelves could make one wonder if that's true. Behind the counter is the typical array of cigarettes and lottery tickets. Under the counter is a glass case containing various useful items.

The clerk, a scruffy man in his mid-twenties, is leaning against the counter, looking bored.

>ASK CLERK ABOUT LOTTERY TICKETS
That doesn't seem to be a topic of conversation at the moment.

>TELL CLERK YOU NEED TO OPEN THE GLASS CASE
That doesn't seem to be a topic of conversation at the moment.

>examine shelves
Goldberg hardly needs bread, ketchup, or potato chips.

>leave store
I only understood you as far as wanting to leave.

>leave
Goldberg exits the store into the relative quiet of the nearby traffic.

Agent Goldberg is at the north end of the strip mall parking lot. This end is no more auspicious than the other. A convenience store lies to the east. To the west is a military recruitment center. North of here the parking lot exits onto a busy road. There is a rusty sign by the road naming the shopping center: Park Place. South is BOSH headquarters, among other things.

>n
Goldberg has things to do here.

>INVESTIGATE MILITARY RECRUITMENT CENTER
I'm not sure what you're trying to say. I might just not recognize the words you're using.

>EXAMINE MILITARY RECRUITMENT CENTER
Patriotic posters paper the windows.

>read posters
The new slogan is "Answer the Call!"

>w
Goldberg will think about joining the military once the Bureau shuts down.

>s
Goldberg walks back to the south end of the parking lot.

Agent Goldberg is at the south end of the strip mall parking lot. From here one can see just how humble BOSH's state has become: the office is to the west, between a pawn shop (to the southwest) and a run-down laundromat (to the northwest) and across from an automatic car wash. To the south is a swampy area separating the lot from the interstate. The parking lot continues north.

Her Hyundai is parked nearby.

>w
Agent Goldberg is in the front office. It's really a small storefront done up to resemble an office. A store sales counter serves as a front desk, behind which are located shelves of office supplies and a row of drawers. There are also a couch and coffee table here creating a makeshift seating area. An old department store clothing rack serves as a coatrack. Photos on the walls picture the Bureau in better days. A stack of used and empty cardboard boxes sits in one corner.

The Bureau's latest office manager, Margaret is bustling around with unrestrained enthusiasm.

A phone is ringing not too far away.

>answer phone
There's nothing like that nearby.

>check drawers
Pens, paper, nothing Goldberg's really concerned with now.

A phone is ringing not too far away.

>e
Agent Goldberg is at the south end of the strip mall parking lot. From here one can see just how humble BOSH's state has become: the office is to the west, between a pawn shop (to the southwest) and a run-down laundromat (to the northwest) and across from an automatic car wash. To the south is a swampy area separating the lot from the interstate. The parking lot continues north.

Her Hyundai is parked nearby.

>w
Agent Goldberg is in the front office. It's really a small storefront done up to resemble an office. A store sales counter serves as a front desk, behind which are located shelves of office supplies and a row of drawers. There are also a couch and coffee table here creating a makeshift seating area. An old department store clothing rack serves as a coatrack. Photos on the walls picture the Bureau in better days. A stack of used and empty cardboard boxes sits in one corner.

The Bureau's latest office manager, Margaret is bustling around with unrestrained enthusiasm.

A phone is ringing not too far away.

>w
Goldberg extricates herself from talking with Margaret.

Agent Goldberg is in the hallway. Her office is to the south, Klimp's is to the west, and Moira's is to the north. The front office is east.

A phone is ringing to the south.

>s
Agent Goldberg is in her office. She pauses and surveys the scene. It's not much -- four white walls, grey industrial carpet. Margaret has helpfully assembled Goldberg's desk and chair, though how sturdily is an open question. She also took the time to put up some of Agent Goldberg's office decor -- her degree in Nonstandard Investigative Techniques, a photo of her dog Pluto, and a print of Green Pheasant by Utagawa Hiroshige. At the very least the wall coverings help compensate for the lack of windows. There's a disconnected landline on the desk. The office door is to the north, and there's a white metal door to the west.

Goldberg mutters, "Where's my computer?"

A phone is ringing inside Goldberg's desk.

>answer phone
There's nothing like that nearby.

>check desk drawers
I only understood you as far as wanting to check Goldberg's desk.

>check desk
The desk is a cheap DIY piece held together with hex screws. It has a single drawer which is closed.

A phone is ringing inside Goldberg's desk.

>open desk drawer
I only understood you as far as wanting to open Goldberg's desk.

>open desk
Goldberg tries to open the desk to answer the phone, but it seems to be locked. She sighs. "Margaret must have the key."

A phone is ringing inside her desk.

>search desk
There is nothing on Goldberg's desk.

A phone is ringing inside her desk.

>check phone
It's not yet hooked up.

A phone is ringing inside Goldberg's desk.

>search drawer
Goldberg can't see inside, since her desk's drawer is closed.

A phone is ringing inside her desk.

>open drawer
It seems to be locked.

A phone is ringing inside Goldberg's desk.

>ASK MARGARET FOR THE DESK DRAWER KEY
I'm not sure what you're trying to say. I might just not recognize the words you're using.

>n
Agent Goldberg is in the hallway. Her office is to the south, Klimp's is to the west, and Moira's is to the north. The front office is east.

A phone is ringing to the south.

>e
Agent Goldberg is in the front office. It's really a small storefront done up to resemble an office. A store sales counter serves as a front desk, behind which are located shelves of office supplies and a row of drawers. There are also a couch and coffee table here creating a makeshift seating area. An old department store clothing rack serves as a coatrack. Photos on the walls picture the Bureau in better days. A stack of used and empty cardboard boxes sits in one corner.

The Bureau's latest office manager, Margaret is bustling around with unrestrained enthusiasm.

A phone is ringing not too far away.

Goldberg can ask about the whereabouts of the desk key or ask about the status of the computer.

>ASK MARGARET ABOUT THE WHEREABOUTS OF THE DESK KEY.
Goldberg says, "Margaret, sweetheart, do you know where my desk key is?"

"Sure I do -- I put it in your desk." She furrows her brow. "What's the matter?"

A phone is ringing not too far away.

Goldberg can ask about the status of the computer or ask for the hex wrench.

>ASK MARGARET ABOUT THE STATUS OF THE COMPUTER
"Margaret", Goldberg says, "what's up with my computer?"

"Oh, it got busted up during the move. I have it behind my desk -- you can see it if you want. We'll have to get you a new one."

A phone is ringing not too far away.

Goldberg can ask for the hex wrench.

>ASK MARGARET FOR THE HEX WRENCH.
Goldberg says, "Do you happen to have the hex wrench from putting together my desk?"

"Well, I did, but I dropped it down a heating vent behind my desk."

A phone is ringing not too far away.

* * *

>2
Agent Goldberg is at the south end of the strip mall parking lot. From here one can see just how humble BOSH's state has become: the office is to the west, between a pawn shop (to the southwest) and a run-down laundromat (to the northwest) and across from an automatic car wash. To the south is a swampy area separating the lot from the interstate. The parking lot continues north.

Her Hyundai is parked nearby.

>w
Just like in the store this once was, the door chimes as Goldberg walks in.

Agent Goldberg is in the front office. It's really a small storefront done up to resemble an office. A store sales counter serves as a front desk, behind which are located shelves of office supplies and a row of drawers. There are also a couch and coffee table here creating a makeshift seating area. An old department store clothing rack serves as a coatrack. Photos on the walls picture the Bureau in better days. A stack of used and empty cardboard boxes sits in one corner.

The Bureau's latest office manager, Margaret is bustling around with unrestrained enthusiasm, unpacking boxes and assembling an approximation of a respectable front office, all as if the Bureau isn't going to be shut down before the year is out. She sees Goldberg and practically squeals. "Agent Goldberg! I'm sorry -- Petula! How are you? I hope you don't mind -- I took the liberty of putting your desk together. I just love hex wrenches, don't you? Also, your new phone is here. I put it in your desk. Now I just need you to give me your old phone so I can deactivate it."

Goldberg hands Margaret her old phone. Margaret taps a few keys on her computer and says "There! All settled."

"Oh, good", Goldberg says. "Our phone downgrades have arrived from our bureaucratic betters."

A phone is ringing somewhere else not too far away.

Goldberg can ask about the phone exchange.

>x photo
There's nothing like that nearby.

>x photos
The photo of Ezra Gaunt and Larch Faraji smiling together is particularly poignant, as they were just let go last month.

A phone is ringing somewhere else not too far away.

Goldberg can ask about the phone exchange.

* * *

>x photos
The photo of Ezra Gaunt and Larch Faraji smiling together is particularly poignant, as they were just let go last month.

A phone is ringing somewhere else not too far away.

Goldberg can ask about the phone exchange.

* * *

>3
Agent Faraji is at the south end of the strip mall parking lot. From here one can see just how humble BOSH's state has become: the office is to the west, between a pawn shop (to the southwest) and a run-down laundromat (to the northwest) and across from an automatic car wash. To the south is a swampy area separating the lot from the interstate. The parking lot continues north.

Their Hyundai is parked nearby.

* * *

>closet
Agent Faraji is in the dark. 

Some light would be nice.

>lens
Agent Faraji is in the utility closet.

>knock on door
After a few seconds, someone inserts a key in the lock and opens the door. It's Faraji's colleague Moira Zin. "How'd you get in there, Larch?"

Faraji exits the closet.

Agent Faraji is in Moira's office. 

On Moira's bookshelves is Native Tribes of Upstate New York.

Also here is Moira Zin.

A phone is ringing somewhere else not too far away.

Wearing the astral lenses in fluorescent light is blinding. Faraji quickly removes the glasses.

Faraji can tell Moira Zin about the hyperdimensional portal or tell Moira Zin to wait for the report.

(talking to Moira Zin)

>e
Agent Faraji is in the utility closet. 

A phone is ringing faintly somewhere else.

>close door
Faraji closes the closet door.

A phone is ringing faintly somewhere else.

It is now pitch dark in here!

>open door
There's nothing like that nearby.

>lights out
A phone is ringing faintly somewhere else.

>l
Agent Faraji is in the dark. 

Some light would be nice.

A phone is ringing faintly somewhere else.

>e
Faraji can't go that way.

A phone is ringing faintly somewhere else.

>w
(first opening the closet door)
Agent Faraji is in the dark. 

Some light would be nice.

A phone is ringing somewhere else not too far away.

Faraji can tell Moira Zin about the hyperdimensional portal or tell Moira Zin to wait for the report.

(talking to Moira Zin)

>lights out
A phone is ringing somewhere else not too far away.

Faraji can tell Moira Zin about the hyperdimensional portal or tell Moira Zin to wait for the report.

(talking to Moira Zin)

>l
Agent Faraji is in the dark. 

Some light would be nice.

A phone is ringing somewhere else not too far away.

Faraji can tell Moira Zin about the hyperdimensional portal or tell Moira Zin to wait for the report.

(talking to Moira Zin)

>scope
1: a pair of astral lenses (1153758)
2: the Bureau credit card (1153022)
3: a green smartphone (1153086)
4: Faraji (1149086)

(talking to Moira Zin)

>showme
Moira's office - room
    *closet door - open door
    *Adjacent light - backdrop
    *Hyperlight - backdrop
    *ceiling - backdrop
    *floor - backdrop
    *wall - backdrop
    Faraji - nonbinary
        pair of astral lenses
        Bureau credit card - money card
        green smartphone - phone
    *Moira's door - closed door
    *Moira Zin - woman
    *moira-light - light source
    *closet - locked container
    *Moira's desk - supporter
        *Moira's drawer (part of Moira's desk) - open container
    *Moira's chair - supporter
    *Moira's bookshelves - supporter
        *Native Tribes of Upstate New York
* denotes things which are not in scope

(talking to Moira Zin)

>showme adjacent light
Adjacent light - backdrop
location: in Moira's office
singular-named, proper-named, unmarked for special listing; unlit, inedible, fixed in place, scenery, neuter, seen, unfamiliar, quiet, background; adjlight
list grouping key: none
printed name: "Adjacent light"
printed plural name: "backdrops"
indefinite article: none
most recent reference: nominal
third singular pronoun: It-pronoun
summary: none
description: none
initial appearance: none
dark description: none
hearability: very loud
volume: 0.0
price: $0
behind description: none
third-plural-pronoun: They-pronoun
possessive: none

(talking to Moira Zin)

>l
Agent Faraji is in the dark. 

Some light would be nice.

A phone is ringing somewhere else not too far away.

Faraji can tell Moira Zin about the hyperdimensional portal or tell Moira Zin to wait for the report.

(talking to Moira Zin)

>s
(first opening Moira's door)
Agent Faraji is in the hallway. Their office is to the south, Klimp's is to the west, and Moira's is to the north. The front office is east.

A phone is ringing to the south.

>n
Agent Faraji is in Moira's office. 

On Moira's bookshelves is Native Tribes of Upstate New York.

Also here is Moira Zin.

A phone is ringing somewhere else not too far away.

Faraji can tell Moira Zin about the hyperdimensional portal or tell Moira Zin to wait for the report.

(talking to Moira Zin)

>close door
Which do you mean, Moira's door or the closet door?

(talking to Moira Zin)

>moira's
Faraji closes Moira's door.

A phone is ringing somewhere else not too far away.

It is now pitch dark in here!

Faraji can tell Moira Zin about the hyperdimensional portal or tell Moira Zin to wait for the report.

(talking to Moira Zin)

>e
Agent Faraji is in the dark. 

Some light would be nice.

A phone is ringing faintly somewhere else.

>w
Agent Faraji is in the dark. 

Some light would be nice.

A phone is ringing somewhere else not too far away.

Faraji can tell Moira Zin about the hyperdimensional portal or tell Moira Zin to wait for the report.

(talking to Moira Zin)

>open door
There's nothing like that nearby.

(talking to Moira Zin)

>wear lenses
Faraji puts on the pair of astral lenses.

A phone is ringing somewhere else not too far away.

Agent Faraji is in Moira's office. 

On Moira's bookshelves is Native Tribes of Upstate New York.

Also here is Moira Zin.

Faraji can tell Moira Zin about the hyperdimensional portal or tell Moira Zin to wait for the report.

(talking to Moira Zin)

>open door
Which do you mean, the closet door or Moira's door?

(talking to Moira Zin)

>moira
I only understood you as far as wanting to open Moira Zin.

(talking to Moira Zin)

>open moira's door
Faraji opens Moira's door.

A phone is ringing somewhere else not too far away.

Faraji can tell Moira Zin about the hyperdimensional portal or tell Moira Zin to wait for the report.

(talking to Moira Zin)

>l
Agent Faraji is in Moira's office. 

On Moira's bookshelves is Native Tribes of Upstate New York.

Also here is Moira Zin.

A phone is ringing somewhere else not too far away.

Faraji can tell Moira Zin about the hyperdimensional portal or tell Moira Zin to wait for the report.

(talking to Moira Zin)

>remove lenses
Faraji takes off the pair of astral lenses.

A phone is ringing somewhere else not too far away.

Faraji can tell Moira Zin about the hyperdimensional portal or tell Moira Zin to wait for the report.

(talking to Moira Zin)

>s
Agent Faraji is in the hallway. Their office is to the south, Klimp's is to the west, and Moira's is to the north. The front office is east.

A phone is ringing to the south.

>n
Agent Faraji is in Moira's office. 

On Moira's bookshelves is Native Tribes of Upstate New York.

Also here is Moira Zin.

A phone is ringing somewhere else not too far away.

Faraji can tell Moira Zin about the hyperdimensional portal or tell Moira Zin to wait for the report.

(talking to Moira Zin)

>showme adjacent light
Adjacent light - backdrop
location: in Moira's office
singular-named, proper-named, unmarked for special listing; lit, inedible, fixed in place, scenery, neuter, seen, unfamiliar, quiet, background; adjlight
list grouping key: none
printed name: "Adjacent light"
printed plural name: "backdrops"
indefinite article: none
most recent reference: nominal
third singular pronoun: It-pronoun
summary: none
description: none
initial appearance: none
dark description: none
hearability: very loud
volume: 0.0
price: $0
behind description: none
third-plural-pronoun: They-pronoun
possessive: none

(talking to Moira Zin)

* * *

>closet
Agent Faraji is in the dark. 

Some light would be nice.

>look
Agent Faraji is in the dark. 

Some light would be nice.

>wear lenses
There's nothing like that nearby.

>purloin lenses
Which do you mean, to borrow the lenses or the pair of astral lenses?

>lens
Agent Faraji is in the utility closet.

>l
Agent Faraji is in the utility closet.

>i
Faraji is carrying:
  a pair of astral lenses (being worn)
  the Bureau credit card
  a green smartphone

>remove lenses
Faraji takes off the pair of astral lenses.

It is now pitch dark in here!

>wear them
Faraji puts on the pair of astral lenses.

Agent Faraji is in the utility closet.

>knock on door
After a few seconds, someone inserts a key in the lock and opens the door. It's Faraji's colleague Moira Zin. "How'd you get in there, Larch?"

Faraji exits the closet.

Agent Faraji is in Moira's office. 

On Moira's bookshelves is Native Tribes of Upstate New York.

Also here is Moira Zin.

A phone is ringing somewhere else not too far away.

Wearing the astral lenses in fluorescent light is blinding. Faraji quickly removes the glasses.

Faraji can tell Moira Zin about the hyperdimensional portal or tell Moira Zin to wait for the report.

(talking to Moira Zin)

>tell moira about the portal
Faraji scratches their head. "Um, I was transported there through an hyperdimensional portal. How's your morning been?

Moira Zin raises an eyebrow. "Well, I suggest you let the Chief know."

A phone is ringing somewhere else not too far away.

(talking to Moira Zin)

>s
(first opening Moira's door)
Agent Faraji is in the hallway. Their office is to the south, Klimp's is to the west, and Moira's is to the north. The front office is east.

A phone is ringing to the south.

>w
(first opening Klimp's door)
It seems to be locked.

A phone is ringing to the south.

>n
Agent Faraji is in Moira's office. 

On Moira's bookshelves is Native Tribes of Upstate New York.

Also here is Moira Zin.

A phone is ringing somewhere else not too far away.

(talking to Moira Zin)

>e
Agent Faraji is in the dark. 

Some light would be nice.

A phone is ringing faintly somewhere else.

>z
Faraji stands around and waits.

A phone is ringing faintly somewhere else.

>l
Agent Faraji is in the dark. 

Some light would be nice.

A phone is ringing faintly somewhere else.

>scope
1: a pair of astral lenses (1152654)
2: the Bureau credit card (1151918)
3: a green smartphone (1151982)
4: Faraji (1147982)

* * *

>closet
Agent Faraji is in the dark. 

Some light would be nice.

>scope
1: the Bureau credit card (1151662)
2: a green smartphone (1151726)
3: Faraji (1147726)

>look
Agent Faraji is in the dark. 

Some light would be nice.

* * *

>closet
Agent Faraji is in the dark. 

Some light would be nice.

>undo
south end of the strip mall parking lot
[Previous turn undone.]

>closet
Agent Faraji is in the dark. 

Some light would be nice.

Agent Faraji is in the utility closet.

>undo
south end of the strip mall parking lot
[Previous turn undone.]

>rules
Rules tracing now switched on. Type "rules off" to switch it off again, or "rules all" to include even rules which do not apply.

[Rule "clear LPR rule" applies.]
[Rule "reset skip sounds rule" applies.]

* * *

>closet
Agent Faraji is in the dark. 

Some light would be nice.

>x door
There's nothing like that nearby.

>l
Agent Faraji is in the dark. 

Some light would be nice.

>scope
1: the Bureau credit card (1151662)
2: a green smartphone (1151726)
3: Faraji (1147726)

* * *

>d
Faraji can't just dig downward.

>n
Faraji trudges to the other end of the parking lot. It's much like where they left.

Agent Faraji is at the north end of the strip mall parking lot. This end is no more auspicious than the other. A convenience store lies to the east. To the west is a military recruitment center. North of here the parking lot exits onto a busy road. There is a rusty sign by the road naming the shopping center: Park Place. South is BOSH headquarters, among other things.

>e
Faraji is greeted by a blast of music as they enter the store.

Agent Faraji is in the Li'l Nectarine Convenience Store. Li'l Nectarine offers great service and low prices, or so they say. This one's cluttered aisles and sparse shelves could make one wonder if that's true. Behind the counter is the typical array of cigarettes and lottery tickets. Under the counter is a glass case containing various useful items.

The clerk, a scruffy man in his mid-twenties, is leaning against the counter, looking bored.

(talking to the store clerk)

>e
Faraji can't go that way.

(talking to the store clerk)

>e
Faraji can't go that way.

(talking to the store clerk)

>n
Faraji can't go that way.

(talking to the store clerk)

>w
Faraji exits the store into the relative quiet of the nearby traffic.

Agent Faraji is at the north end of the strip mall parking lot. This end is no more auspicious than the other. A convenience store lies to the east. To the west is a military recruitment center. North of here the parking lot exits onto a busy road. There is a rusty sign by the road naming the shopping center: Park Place. South is BOSH headquarters, among other things.

>w
Faraji will think about joining the military once the Bureau shuts down.

>s
Faraji walks back to the south end of the parking lot.

Agent Faraji is at the south end of the strip mall parking lot. From here one can see just how humble BOSH's state has become: the office is to the west, between a pawn shop (to the southwest) and a run-down laundromat (to the northwest) and across from an automatic car wash. To the south is a swampy area separating the lot from the interstate. The parking lot continues north.

Their Hyundai is parked nearby.

I beg your pardon?

>n
Agent Faraji is at the north end of the strip mall parking lot. This end is no more auspicious than the other. A convenience store lies to the east. To the west is a military recruitment center. North of here the parking lot exits onto a busy road. There is a rusty sign by the road naming the shopping center: Park Place. South is BOSH headquarters, among other things.

>e
Agent Faraji is in the Li'l Nectarine Convenience Store. Li'l Nectarine offers great service and low prices, or so they say. This one's cluttered aisles and sparse shelves could make one wonder if that's true. Behind the counter is the typical array of cigarettes and lottery tickets. Under the counter is a glass case containing various useful items.

The clerk, a scruffy man in his mid-twenties, is leaning against the counter, looking bored.

(talking to the store clerk)

>e
Faraji can't go that way.

(talking to the store clerk)

>lens
I'm not sure what you're trying to say. I might just not recognize the words you're using.

(talking to the store clerk)

>e
Faraji can't go that way.

(talking to the store clerk)

>f
Faraji can't go that way.

(talking to the store clerk)

>drop lens
There's nothing like that nearby.

(talking to the store clerk)

>wear it
Faraji can't see 'it' (nothing) at the moment.

(talking to the store clerk)

* * *

>e
An automatic car wash isn't of much use when one is on foot.

>w
Just like in the store this once was, the door chimes as Faraji walks in.

Agent Faraji is in the front office. It's really a small storefront done up to resemble an office. A store sales counter serves as a front desk, behind which are located shelves of office supplies and a row of drawers. There are also a couch and coffee table here creating a makeshift seating area. An old department store clothing rack serves as a coatrack. Photos on the walls picture the Bureau in better days. A stack of used and empty cardboard boxes sits in one corner.

The Bureau's latest office manager, Margaret is bustling around with unrestrained enthusiasm, unpacking boxes and assembling an approximation of a respectable front office, all as if the Bureau isn't going to be shut down before the year is out. She sees Faraji and practically squeals. "Agent Faraji! I'm sorry -- Larch! How are you? I hope you don't mind -- I took the liberty of putting your desk together. I just love hex wrenches, don't you? Also, your new phone is here. I put it in your desk. Good timing! Now I just need you to give me your old phone so I can deactivate it."

Faraji hands Margaret their old phone. Margaret taps a few keys on her computer and says "There! All settled."

"Oh, good", Faraji says. "Our phone downgrades have arrived from our bureaucratic betters."

A phone is ringing not too far away.

>w
Faraji extricates themself from talking with Margaret.

Agent Faraji is in the hallway. Their office is to the south, Klimp's is to the west, and Moira's is to the north. The front office is east.

A phone is ringing to the south.

>w
(first opening Klimp's door)
It seems to be locked.

A phone is ringing to the south.

>s
Agent Faraji is in their office. They pause and survey the scene. It's not much -- four white walls, grey industrial carpet. Margaret has helpfully assembled Faraji's desk and chair, though how sturdily is an open question. She also took the time to put up some of Agent Faraji's office decor -- their degree in Nonstandard Investigative Techniques, an original pencil drawing of the Pitfall snake by semi-acclaimed Washington DC artist Darius 5200, and a photo of their softball team. At the very least the wall coverings help compensate for the lack of windows. There's a disconnected landline on the desk. The office door is to the north, and there's a white metal door to the west.

Faraji mutters, "Where's my computer?"

A phone is ringing inside Faraji's desk.

>n
Agent Faraji is in the hallway. Their office is to the south, Klimp's is to the west, and Moira's is to the north. The front office is east.

A phone is ringing to the south.

>e
Agent Faraji is in the front office. It's really a small storefront done up to resemble an office. A store sales counter serves as a front desk, behind which are located shelves of office supplies and a row of drawers. There are also a couch and coffee table here creating a makeshift seating area. An old department store clothing rack serves as a coatrack. Photos on the walls picture the Bureau in better days. A stack of used and empty cardboard boxes sits in one corner.

The Bureau's latest office manager, Margaret is bustling around with unrestrained enthusiasm.

A phone is ringing not too far away.

Faraji can ask about the status of the computer.

>e
Faraji steps out of the office into the parking lot.

Agent Faraji is at the south end of the strip mall parking lot. From here one can see just how humble BOSH's state has become: the office is to the west, between a pawn shop (to the southwest) and a run-down laundromat (to the northwest) and across from an automatic car wash. To the south is a swampy area separating the lot from the interstate. The parking lot continues north.

Their Hyundai is parked nearby.

* * *

>engima
I'm not sure what you're trying to say. I might just not recognize the words you're using.

>enigma
Agent Faraji is in the Enigma Lake town hall. The building has been cleared of furniture and other items ahead of the imminent flooding. A permanent fixture, the information desk sits near the front entrance (to the south). Taped to it is what looks to be a work schedule. There is also a back entrance onto the park to the north.

>x desk
A work schedule is taped to the desk.

Faraji finds a backpack behind the information desk and takes it.

>x backpack
Stitched into the fabric are the initials "WT"

>open it
Faraji opens the backpack, revealing a red key.

>take key then x it
Taken.

The letters ELG are printed on the key, labeling it the property of Enigma Lake Gymnasium.

>n
Agent Faraji is in Enigma Park. It's probably beautiful during the day, but tonight the deep shadows among the trees seem ominous. Faraji is watchful and tense as they explore the park.

The central focus of the park is a large obelisk inscribed with the names of the town's citizens lost in the Great War. The town hall is to the south, and other exits are to the north, west, and east.

The seeming sound of sibilant speech carries on the breeze.

>e
Agent Faraji is walking on Lake Street by the park.

>s
Agent Faraji is walking on Lake Street by the gym.

>e
(first opening the gym door)
It seems to be locked.

The seeming sound of sibilant speech carries on the breeze.

>l
Agent Faraji is walking on Lake Street by the gym.

>e
(first opening the gym door)
It seems to be locked.

>w
You can't enter the town hall from here.

>nw
You can't enter the town hall from here.

>sw
You can't enter the town hall from here.

The seeming sound of sibilant speech carries on the breeze.

>l
Agent Faraji is walking on Lake Street by the gym.

>x town hall
The archetypical town hall of the northeastern US, it's a white-sided building the size of a large house, exuding a sense of civic duty. There are no entrances on this side.

>s
Agent Faraji is on Main and Lake.

>w
Agent Faraji is on 200 block of Main Street. 

The seeming sound of sibilant speech carries on the breeze.

>x hall
The archetypical town hall of the northeastern US, it's a white-sided building the size of a large house, exuding a sense of civic duty. The front entrance is to the north.

>e
Agent Faraji is on Main and Lake.

>x hall
The archetypical town hall of the northeastern US, it's a white-sided building the size of a large house, exuding a sense of civic duty. There are no entrances on this side.

The seeming sound of sibilant speech carries on the breeze.

>n
Agent Faraji is walking on Lake Street by the gym.

>s
Agent Faraji is on Main and Lake.

* * *

>w
Agent Faraji is on 200 block of Main Street. 

The seeming sound of sibilant speech carries on the breeze.

>n
Agent Faraji is in the Enigma Lake town hall. The building has been cleared of furniture and other items ahead of the imminent flooding. A permanent fixture, the information desk sits near the front entrance (to the south). Taped to it is what looks to be a work schedule. There is also a back entrance onto the park to the north.

>x town hall
Agent Faraji is in the Enigma Lake town hall. The building has been cleared of furniture and other items ahead of the imminent flooding. A permanent fixture, the information desk sits near the front entrance (to the south). Taped to it is what looks to be a work schedule. There is also a back entrance onto the park to the north.

>s
Agent Faraji is on 200 block of Main Street.

>l
Agent Faraji is on 200 block of Main Street. 

The seeming sound of sibilant speech carries on the breeze.

>x hall
The archetypical town hall of the northeastern US, it's a white-sided building the size of a large house, exuding a sense of civic duty. The front entrance is to the north.

>w
Agent Faraji is on Main and Solvay.

>x hall
The archetypical town hall of the northeastern US, it's a white-sided building the size of a large house, exuding a sense of civic duty. There are no entrances on this side.

The seeming sound of sibilant speech carries on the breeze.

>n
Agent Faraji is walking on Solvay Road by the fire station.

>x hall
The archetypical town hall of the northeastern US, it's a white-sided building the size of a large house, exuding a sense of civic duty. There are no entrances on this side.

>n
Agent Faraji is walking on Solvay Road leading out of town.

>n
Agent Faraji is at the west end of the town's lake shore.

>e
Agent Faraji is on the lake shore north of the park. 

The seeming sound of sibilant speech carries on the breeze.

>s
Agent Faraji is in Enigma Park. The central focus of the park is a large obelisk inscribed with the names of the town's citizens lost in the Great War. The town hall is to the south, and other exits are to the north, west, and east.

>x hall
The archetypical town hall of the northeastern US, it's a white-sided building the size of a large house, exuding a sense of civic duty. The back entrance is to the south.

>show me town hall
Faraji doesn't generally talk to themself.

>showme town hall
(the town hall)
town hall - backdrop
location: in Enigma Park
singular-named, improper-named, unmarked for special listing; unlit, inedible, fixed in place, scenery, neuter, seen, familiar, quiet, background
list grouping key: none
printed name: "town hall"
printed plural name: "backdrops"
indefinite article: none
most recent reference: nominal
third singular pronoun: It-pronoun
summary: none
description: "The archetypical town hall of the northeastern US, it's a white-sided building the size of a large house, exuding a sense of civic duty. The back entrance is to the south."
initial appearance: none
dark description: none
hearability: very loud
volume: 0.0
price: $0
behind description: none
third-plural-pronoun: They-pronoun
possessive: none

>s
Agent Faraji is in the Enigma Lake town hall. The building has been cleared of furniture and other items ahead of the imminent flooding. A permanent fixture, the information desk sits near the front entrance (to the south). Taped to it is what looks to be a work schedule. There is also a back entrance onto the park to the north.

>showme
Enigma Lake town hall - room
    Hyperlight - backdrop
    ceiling - backdrop
    floor - backdrop
    wall - backdrop
    Faraji - nonbinary
        red key - key
        backpack - open container
        Bureau credit card - money card
        recall button
        pair of astral lenses (worn)
    information desk
    work schedule
    building

>s
Agent Faraji is on 200 block of Main Street. 

The seeming sound of sibilant speech carries on the breeze.

>showme 200 block
200 block of Main Street - room
    town hall - backdrop
    Hyperlight - backdrop
    ceiling - backdrop
    floor - backdrop
    wall - backdrop
    Faraji - nonbinary
        red key - key
        backpack - open container
        Bureau credit card - money card
        recall button
        pair of astral lenses (worn)
singular-named, proper-named, unmarked for special listing; lighted, visited, fully lit
list grouping key: none
printed name: "200 block of Main Street"
printed plural name: none
indefinite article: none
most recent reference: nominal
third singular pronoun: It-pronoun
summary: none
description: none
map region: ELR
dark description: none
reception: true
preposition: "on"
destination name: none
room condition: outdoors

>e
Agent Faraji is on Main and Lake.

>showme town hall
(the town hall)
town hall - backdrop
location: in Main and Lake
singular-named, improper-named, unmarked for special listing; unlit, inedible, fixed in place, scenery, neuter, seen, familiar, quiet, background
list grouping key: none
printed name: "town hall"
printed plural name: "backdrops"
indefinite article: none
most recent reference: nominal
third singular pronoun: It-pronoun
summary: none
description: "The archetypical town hall of the northeastern US, it's a white-sided building the size of a large house, exuding a sense of civic duty. There are no entrances on this side."
initial appearance: none
dark description: none
hearability: very loud
volume: 0.0
price: $0
behind description: none
third-plural-pronoun: They-pronoun
possessive: none

>nw
Faraji can't go that way.

>w
Agent Faraji is on 200 block of Main Street.

>nw
Go north to enter the town hall.

The seeming sound of sibilant speech carries on the breeze.

>sw
You can go north into the town hall, or south into Rolle's Department Store. In addition, Main Street leads east and west.

* * *

>enigma
Agent Faraji is in the Enigma Lake town hall. The building has been cleared of furniture and other items ahead of the imminent flooding. A permanent fixture, the information desk sits near the front entrance (to the south). Taped to it is what looks to be a work schedule. There is also a back entrance onto the park to the north.

>gonear field office
Which do you mean, field office area, field office reception, the field office hallway or the field office chief's office?

>reception
Agent Faraji is at field office reception. Hooray you made it!

Also here is Maggie.

>w
Agent Faraji is in the field office hallway. Hallway

>b
Agent Faraji is in Portal Room 2.

>f
Agent Faraji is in the field office hallway. Hallway

>f
Agent Faraji is in Portal Room 1. 

Also here is a portal to the past.

>gonear closet
(the utility closet)
Agent Faraji is in the dark. 

Some light would be nice.

>open door
There's nothing like that nearby.

>scope
1: the Bureau credit card (1150018)
2: a recall button (1143554)
3: a pair of astral lenses (1150754)
4: Faraji (1146114)

>knock
What do you want to knock?

>door
There's nothing like that nearby.

>yell
I'm not sure what you're trying to say. I might just not recognize the words you're using.

>wear lenses
Faraji's already wearing that!

>l
Agent Faraji is in the dark. 

Some light would be nice.

>remove lenses
Faraji takes off the pair of astral lenses.

>wear them
Faraji puts on the pair of astral lenses.

Agent Faraji is in the utility closet.

>l
Agent Faraji is in the utility closet.

>knock on door
After a few seconds, someone inserts a key in the lock and opens the door. It's Faraji's colleague Moira Zin. "How'd you get in there, Larch?"

You exit the closet.

Agent Faraji is in Moira's office. 

On Moira's bookshelves is Native Tribes of Upstate New York.

Also here is Moira Zin.

A phone is ringing somewhere else not too far away.

Wearing the astral lenses in fluorescent light is blinding. Faraji quickly removes the glasses.

Faraji can tell Moira Zin about the hyperdimensional portal or tell Moira Zin to wait for the report.

(talking to Moira Zin)

>enter closet
Which do you mean, the closet door or the closet?

(talking to Moira Zin)

>closet
Which do you mean, the closet door or the closet?

(talking to Moira Zin)

>e
I only understood you as far as wanting to enter east.

(talking to Moira Zin)

>e
Agent Faraji is in the dark. 

Some light would be nice.

A phone is ringing faintly somewhere else.

>w
Agent Faraji is in Moira's office. 

On Moira's bookshelves is Native Tribes of Upstate New York.

Also here is Moira Zin.

A phone is ringing somewhere else not too far away.

Faraji can tell Moira Zin about the hyperdimensional portal or tell Moira Zin to wait for the report.

(talking to Moira Zin)

>showme utility closet
utility closet - room
singular-named, improper-named, unmarked for special listing; dark, visited, fully lit
list grouping key: none
printed name: "utility closet"
printed plural name: none
indefinite article: none
most recent reference: nominal
third singular pronoun: It-pronoun
summary: none
description: none
map region: BOSH HQ
dark description: none
reception: true
preposition: "in"
destination name: none
room condition: indoors

(talking to Moira Zin)

* * *

>enigma
Agent Faraji is in the Enigma Lake town hall. The building has been cleared of furniture and other items ahead of the imminent flooding. A permanent fixture, the information desk sits near the front entrance (to the south). Taped to it is what looks to be a work schedule. There is also a back entrance onto the park to the north.

>i
Faraji is carrying:
  the Bureau credit card
  a recall button
  a pair of astral lenses (being worn)
  a green smartphone

* * *

>enigma
Agent Faraji is in the Enigma Lake town hall. The building has been cleared of furniture and other items ahead of the imminent flooding. A permanent fixture, the information desk sits near the front entrance (to the south). Taped to it is what looks to be a work schedule. There is also a back entrance onto the park to the north.

>look behind desk
Faraji finds a backpack and pulls it out.

>undo
Enigma Lake town hall
[Previous turn undone.]

>x desk
A work schedule is taped to the desk.

Faraji finds a backpack behind the information desk and takes it.

>look behind desk
Faraji finds a backpack and pulls it out.

>look behind desk
Faraji looks, but there is nothing behind the information desk.

* * *

>look behind desk
Faraji finds a backpack and pulls it out.

>x desk
There seems to be nothing special about it.

Faraji finds a backpack behind the information desk and takes it.

* * *

>enigma
Agent Faraji is in the Enigma Lake town hall. The building has been cleared of furniture and other items ahead of the imminent flooding. A permanent fixture, the information desk sits near the front entrance (to the south). Taped to it is what looks to be a work schedule. There is also a back entrance onto the park to the north.

>look behind the desk
Faraji finds a backpack and pulls it out.

>open backpack
Faraji opens the backpack, revealing a red key.

>x key
The letters ELG are printed on the key, labeling it the property of Enigma Lake Gymnasium.

I beg your pardon?

I beg your pardon?

* * *

>enigma
Agent Faraji is in the Enigma Lake town hall. The building has been cleared of furniture and other items ahead of the imminent flooding. A permanent fixture, the information desk sits near the front entrance (to the south). Taped to it is what looks to be a work schedule. There is also a back entrance onto the park to the north.

>ls
I'm not sure what you're trying to say. I might just not recognize the words you're using.

>i
Faraji is carrying:
  the Bureau credit card
  a recall button
  a pair of astral lenses (being worn)

>press button
The world turns inside out, and suddenly you're somewhere else.

Agent Faraji is in the field office chief's office. Doris's office

Doris is sitting cross-legged in a chair, tapping his foot lazily on the desk.

"Ah, Larch," Doris exclaims, standing up to shake their hand. "I've been waiting for you to pay us a visit. Did you bring the thumb drive?"

>enigma
Agent Faraji is in the Enigma Lake town hall.

>n
Agent Faraji is in Enigma Park.

>press button
The world turns inside out, and suddenly you're somewhere else.

Agent Faraji is in the field office chief's office. Doris's office

Doris is sitting cross-legged in a chair, tapping his foot lazily on the desk.

>undo
Enigma Park
[Previous turn undone.]

* * *

>enigma
Agent Faraji is in the Enigma Lake town hall. The building has been cleared of furniture and other items ahead of the imminent flooding. A permanent fixture, the information desk sits near the front entrance (to the south). Taped to it is what looks to be a work schedule. There is also a back entrance onto the park to the north.

>n
Agent Faraji is in Enigma Park. It's probably beautiful during the day, but tonight the deep shadows among the trees seem ominous. They are watchful and tense as they explore the park.

The central focus of the park is a large obelisk inscribed with the names of the town's citizens lost in the Great War.

>e
Agent Faraji is in Lake Street by the Park.

>e
Agent Faraji is in First Unitarian Church of Enigma Lake.

>s
Faraji can't go that way.

>w
Agent Faraji is in Lake Street by the Park.

>s
Agent Faraji is in Lake Street by the gym.

>e
Agent Faraji is in the public gymnasium. There is a basketball court and a weight training area. A front desk is next to the front entrance.

>d
Agent Faraji is in the gym basement. This area is dominated by large banks of lockers.

>open locker
It isn't something Faraji can open.

>i
Faraji is carrying:
  the Bureau credit card
  a recall button
  a pair of astral lenses (being worn)

>look up
Faraji sees nothing special about the ceiling.

>look up 34
I only understood you as far as wanting to look up.

>look up johnson
I only understood you as far as wanting to look up.

* * *

>enigma
Agent Faraji is in the Enigma Lake town hall. The building has been cleared of furniture and other items ahead of the imminent flooding. A permanent fixture, the information desk sits near the front entrance (to the south). Taped to it is what looks to be a work schedule. There is also a back entrance onto the park to the north.

>read schedule
Name  Shift
 Edward Alpha  Tuesday

* * *

>enigma
Agent Faraji is in the Enigma Lake town hall. The building has been cleared of furniture and other items ahead of the imminent flooding. A permanent fixture, the information desk sits near the front entrance (to the south). Taped to it is what looks to be a work schedule. There is also a back entrance onto the park to the north.

>read work
 +--------------------------------+
 |Name            Shift           |
 +--------------------------------+
 |Monday          Edward Alpha    |
 |Tuesday         Mary Huff       |
 |Wednesday       Jeff Thompson   |
 |Thursday        Edward Alpha    |
 |Friday          Rosemary Klein  |
 |Saturday        Mary Huff       |
 +--------------------------------+

>x deks
There's nothing like that nearby.

>x desk
A work schedule is taped to the desk.

Faraji finds a backpack behind the information desk and takes it.

>open pack
There's nothing like that nearby.

* * *

>enigma
Agent Faraji is in the Enigma Lake town hall. The building has been cleared of furniture and other items ahead of the imminent flooding. A permanent fixture, the information desk sits near the front entrance (to the south). Taped to it is what looks to be a work schedule. There is also a back entrance onto the park to the north.

>s
Agent Faraji is on the 200 block of Main Street.

>x town hall
The archetypical town hall of the northeastern US, it's a white-sided building the size of a large house, exuding a sense of civic duty.

>n
Agent Faraji is in the Enigma Lake town hall. This is the lobby. The rest of the building is locked up tight. The main feature here is the information desk. Taped to it is what looks to be a work schedule.

>n
Agent Faraji is in Enigma Park. It's probably beautiful during the day, but tonight the deep shadows among the trees seem ominous. Faraji is watchful and tense as they explore the park.

The central focus of the park is a large obelisk inscribed with the names of the town's citizens lost in the Great War.

>s
Agent Faraji is in the Enigma Lake town hall. This is the lobby. The rest of the building is locked up tight. The main feature here is the information desk. Taped to it is what looks to be a work schedule.

>read schedule
 +--------------------------------+
 |Name            Shift           |
 +--------------------------------+
 |Monday          Edward Alpha    |
 |Tuesday         Mary Huff       |
 |Wednesday       Bill Thompson   |
 |Thursday        Edward Alpha    |
 |Friday          Rosemary Tamsin |
 |Saturday        Mary Huff       |
 +--------------------------------+

>look behind desk
Faraji finds a backpack and pulls it out.

>open backpack
Faraji opens the backpack, revealing a red key.

* * *

>x key
The letters ELG are printed on the key, labeling it the property of Enigma Lake Gymnasium.

>e
Faraji can't go that way.

I beg your pardon?

* * *

I beg your pardon?

>n
Agent Faraji is in Enigma Park. It's probably beautiful during the day, but tonight the deep shadows among the trees seem ominous. Faraji is watchful and tense as they explore the park.

The central focus of the park is a large obelisk inscribed with the names of the town's citizens lost in the Great War.

>e
Agent Faraji is in Lake Street by the Park.

* * *

>e
Agent Faraji is in First Unitarian Church of Enigma Lake.

>w
Agent Faraji is in Lake Street by the Park.

* * *

>d
Agent Faraji is in the gym basement. This area is dominated by large banks of lockers.

>open 1
Faraji doesn't have a key for the locker.

>open 12
Faraji doesn't have a key for the locker.

>open 2
Faraji doesn't have a key for the locker.

>open 3
Faraji doesn't have a key for the locker.

* * *

>gonear back basement
Agent Faraji is in the back basement. The basement ends here. There is a switch on the wall, currently on. A doorway leads north.

A strange glow emanates from behind some stacks of large crates.

>flip switch
I'm not sure what you're trying to say. I might just not recognize the words you're using.

>turn off light
Faraji switches the light switch off.

It is now pitch dark in here!

>l
Agent Faraji is in the dark. It is pitch dark, and they can't see a thing.

There is a glow-in-the-dark light switch on the wall here, currently off.

There is a strange glow emanating from behind some large dark objects.

>purloin hand truck
[Purloined.]

>drop it
Dropped.

>move cabinets
There's nothing like that nearby.

>turn on light
Faraji switches the light switch on.

Agent Faraji is in the back basement. The basement ends here. There is a switch on the wall, currently on. A doorway leads north.

A strange glow emanates from behind some stacks of large crates.

Also here is a handtruck.

>move cabinets
There's nothing like that nearby.

>move crates
Faraji can't move that.

>move crates with truck
You move the crates out of the way and uncover an old front-loading washing machine. There is a strange glow inside the drum.

>turn off light
Faraji switches the light switch off.

It is now pitch dark in here!

>l
Agent Faraji is in the dark. It is pitch dark, and they can't see a thing.

There is a glow-in-the-dark light switch on the wall here, currently off.

A washing machine is revealed in the darkness by the glow emanating from its drum.

>turn on light
Faraji switches the light switch on.

Agent Faraji is in the back basement. The basement ends here. There is a switch on the wall, currently on. A doorway leads north.

A old broken-down washing machine peeks out from between two stacks of crates.

Also here is a handtruck.

>enter machine
Faraji can't get into the closed broken washing machine.

>open it
Faraji opens the broken washing machine.

>enter machine
There is a flash of light and Faraji finds themself somewhere else...

Agent Faraji is on a featureless hyperplane. They rub their eyes as they try to take in their surroundings. In addition to the usual directions of north and south and east and west, two new directions exist here: back and forth. As a result, the "surface" they're standing on is in fact a three-dimensional hyperplane. Up and down still exist, and there is gravity, apparently.

As far as one can see, the hyperplane extends infinitely in all six directions.

In the middle distance is some kind of structure, roughly to the forth.

>f
Agent Faraji is on a featureless hyperplane. In addition to the usual directions of north and south and east and west, two new directions exist here: back and forth. As a result, the "surface" they're standing on is in fact a three-dimensional hyperplane. Up and down still exist, and there is gravity, apparently.

As far as one can see, the hyperplane extends infinitely in all six directions.

In the middle distance is some kind of structure, roughly to the forth.

>f
Agent Faraji is on a featureless hyperplane. In addition to the usual directions of north and south and east and west, two new directions exist here: back and forth. As a result, the "surface" they're standing on is in fact a three-dimensional hyperplane. Up and down still exist, and there is gravity, apparently.

As far as one can see, the hyperplane extends infinitely in all six directions.

In the middle distance is some kind of structure, roughly to the forth.

>f
Agent Faraji is on a featureless hyperplane. In addition to the usual directions of north and south and east and west, two new directions exist here: back and forth. As a result, the "surface" they're standing on is in fact a three-dimensional hyperplane. Up and down still exist, and there is gravity, apparently.

As far as one can see, the hyperplane extends infinitely in all six directions.

Not too far off is some kind of structure, roughly to the forth.

>f
Agent Faraji is on a featureless hyperplane. In addition to the usual directions of north and south and east and west, two new directions exist here: back and forth. As a result, the "surface" they're standing on is in fact a three-dimensional hyperplane. Up and down still exist, and there is gravity, apparently.

As far as one can see, the hyperplane extends infinitely in all six directions.

Not too far off is some kind of structure, roughly to the forth.

>f
Agent Faraji is on a featureless hyperplane. In addition to the usual directions of north and south and east and west, two new directions exist here: back and forth. As a result, the "surface" they're standing on is in fact a three-dimensional hyperplane. Up and down still exist, and there is gravity, apparently.

As far as one can see, the hyperplane extends infinitely in all six directions.

Not too far off is some kind of structure, roughly to the forthnorth.

>fn
Agent Faraji is on a featureless hyperplane. In addition to the usual directions of north and south and east and west, two new directions exist here: back and forth. As a result, the "surface" they're standing on is in fact a three-dimensional hyperplane. Up and down still exist, and there is gravity, apparently.

As far as one can see, the hyperplane extends infinitely in all six directions.

Not too far off is some kind of structure, roughly to the forthwest.

>fw
Agent Faraji is on a featureless hyperplane. In addition to the usual directions of north and south and east and west, two new directions exist here: back and forth. As a result, the "surface" they're standing on is in fact a three-dimensional hyperplane. Up and down still exist, and there is gravity, apparently.

As far as one can see, the hyperplane extends infinitely in all six directions.

Not too far off is some kind of structure, roughly to the forthnorth.

>fn
Agent Faraji is on a featureless hyperplane. In addition to the usual directions of north and south and east and west, two new directions exist here: back and forth. As a result, the "surface" they're standing on is in fact a three-dimensional hyperplane. Up and down still exist, and there is gravity, apparently.

As far as one can see, the hyperplane extends infinitely in all six directions.

Not too far off is some kind of structure, roughly to the forthnorth.

>fn
Agent Faraji is on a featureless hyperplane. In addition to the usual directions of north and south and east and west, two new directions exist here: back and forth. As a result, the "surface" they're standing on is in fact a three-dimensional hyperplane. Up and down still exist, and there is gravity, apparently.

As far as one can see, the hyperplane extends infinitely in all six directions.

Not too far off is some kind of structure, roughly to the forthwest.

>fw
Agent Faraji is on a featureless hyperplane. In addition to the usual directions of north and south and east and west, two new directions exist here: back and forth. As a result, the "surface" they're standing on is in fact a three-dimensional hyperplane. Up and down still exist, and there is gravity, apparently.

As far as one can see, the hyperplane extends infinitely in all six directions.

Not too far off is some kind of structure, roughly to the west.

>w
Agent Faraji is on a featureless hyperplane. In addition to the usual directions of north and south and east and west, two new directions exist here: back and forth. As a result, the "surface" they're standing on is in fact a three-dimensional hyperplane. Up and down still exist, and there is gravity, apparently.

As far as one can see, the hyperplane extends infinitely in all six directions.

Close by is some kind of structure to the forthnorth.

>fn
Agent Faraji is on a featureless hyperplane. In addition to the usual directions of north and south and east and west, two new directions exist here: back and forth. As a result, the "surface" they're standing on is in fact a three-dimensional hyperplane. Up and down still exist, and there is gravity, apparently.

As far as one can see, the hyperplane extends infinitely in all six directions.

Close by is some kind of structure to the west.

>w
Agent Faraji is next to an ethereal pillar. In addition to the usual directions of north and south and east and west, two new directions exist here: back and forth. As a result, the "surface" they're standing on is in fact a three-dimensional hyperplane. Up and down still exist, and there is gravity, apparently.

As far as one can see, the hyperplane extends infinitely in all six directions.

There is an ethereal pillar here. A message carved into the pillar says "Seek the origin. -Doris"

Under that is a line of five strange symbols:     

A mystic compass dangles from an outcropping of the pillar.

Also here is an Ethereal Pillar.

>take compass
Taken.

>read it
On the readout of the mystic compass floats a set of ethereal symbols:  :  :

>e
Agent Faraji is on a featureless hyperplane. In addition to the usual directions of north and south and east and west, two new directions exist here: back and forth. As a result, the "surface" they're standing on is in fact a three-dimensional hyperplane. Up and down still exist, and there is gravity, apparently.

As far as one can see, the hyperplane extends infinitely in all six directions.

On the readout of the mystic compass floats a set of ethereal symbols:  :  : 

Close by is some kind of structure to the west.

>e
Agent Faraji is on a featureless hyperplane. In addition to the usual directions of north and south and east and west, two new directions exist here: back and forth. As a result, the "surface" they're standing on is in fact a three-dimensional hyperplane. Up and down still exist, and there is gravity, apparently.

As far as one can see, the hyperplane extends infinitely in all six directions.

On the readout of the mystic compass floats a set of ethereal symbols:  :  : 

Not too far off is some kind of structure, roughly to the west.

>e
Agent Faraji is on a featureless hyperplane. In addition to the usual directions of north and south and east and west, two new directions exist here: back and forth. As a result, the "surface" they're standing on is in fact a three-dimensional hyperplane. Up and down still exist, and there is gravity, apparently.

As far as one can see, the hyperplane extends infinitely in all six directions.

On the readout of the mystic compass floats a set of ethereal symbols:  :  : 

Not too far off is some kind of structure, roughly to the west.

>n
Agent Faraji is on a featureless hyperplane. In addition to the usual directions of north and south and east and west, two new directions exist here: back and forth. As a result, the "surface" they're standing on is in fact a three-dimensional hyperplane. Up and down still exist, and there is gravity, apparently.

As far as one can see, the hyperplane extends infinitely in all six directions.

On the readout of the mystic compass floats a set of ethereal symbols:  :  : 

Not too far off is some kind of structure, roughly to the west.

>n
Agent Faraji is on a featureless hyperplane. In addition to the usual directions of north and south and east and west, two new directions exist here: back and forth. As a result, the "surface" they're standing on is in fact a three-dimensional hyperplane. Up and down still exist, and there is gravity, apparently.

As far as one can see, the hyperplane extends infinitely in all six directions.

On the readout of the mystic compass floats a set of ethereal symbols:  :  : 

Not too far off is some kind of structure, roughly to the west.

>s
Agent Faraji is on a featureless hyperplane. In addition to the usual directions of north and south and east and west, two new directions exist here: back and forth. As a result, the "surface" they're standing on is in fact a three-dimensional hyperplane. Up and down still exist, and there is gravity, apparently.

As far as one can see, the hyperplane extends infinitely in all six directions.

On the readout of the mystic compass floats a set of ethereal symbols:  :  : 

Not too far off is some kind of structure, roughly to the west.

>s
Agent Faraji is on a featureless hyperplane. In addition to the usual directions of north and south and east and west, two new directions exist here: back and forth. As a result, the "surface" they're standing on is in fact a three-dimensional hyperplane. Up and down still exist, and there is gravity, apparently.

As far as one can see, the hyperplane extends infinitely in all six directions.

On the readout of the mystic compass floats a set of ethereal symbols:  :  : 

Not too far off is some kind of structure, roughly to the west.

>s
Agent Faraji is on a featureless hyperplane. In addition to the usual directions of north and south and east and west, two new directions exist here: back and forth. As a result, the "surface" they're standing on is in fact a three-dimensional hyperplane. Up and down still exist, and there is gravity, apparently.

As far as one can see, the hyperplane extends infinitely in all six directions.

On the readout of the mystic compass floats a set of ethereal symbols:  :  : 

Not too far off is some kind of structure, roughly to the northwest.

>s
Agent Faraji is on a featureless hyperplane. In addition to the usual directions of north and south and east and west, two new directions exist here: back and forth. As a result, the "surface" they're standing on is in fact a three-dimensional hyperplane. Up and down still exist, and there is gravity, apparently.

As far as one can see, the hyperplane extends infinitely in all six directions.

On the readout of the mystic compass floats a set of ethereal symbols:  :  : 

Not too far off is some kind of structure, roughly to the northwest.

>s
Agent Faraji is on a featureless hyperplane. In addition to the usual directions of north and south and east and west, two new directions exist here: back and forth. As a result, the "surface" they're standing on is in fact a three-dimensional hyperplane. Up and down still exist, and there is gravity, apparently.

As far as one can see, the hyperplane extends infinitely in all six directions.

On the readout of the mystic compass floats a set of ethereal symbols:  :  : 

In the middle distance is some kind of structure, roughly to the northwest.

>s
Agent Faraji is on a featureless hyperplane. In addition to the usual directions of north and south and east and west, two new directions exist here: back and forth. As a result, the "surface" they're standing on is in fact a three-dimensional hyperplane. Up and down still exist, and there is gravity, apparently.

As far as one can see, the hyperplane extends infinitely in all six directions.

On the readout of the mystic compass floats a set of ethereal symbols:  :  : 

In the middle distance is some kind of structure, roughly to the northwest.

>b
Agent Faraji is on a featureless hyperplane. In addition to the usual directions of north and south and east and west, two new directions exist here: back and forth. As a result, the "surface" they're standing on is in fact a three-dimensional hyperplane. Up and down still exist, and there is gravity, apparently.

As far as one can see, the hyperplane extends infinitely in all six directions.

On the readout of the mystic compass floats a set of ethereal symbols:  :  : 

In the middle distance is some kind of structure, roughly to the northwest.

>b
Agent Faraji is on a featureless hyperplane. In addition to the usual directions of north and south and east and west, two new directions exist here: back and forth. As a result, the "surface" they're standing on is in fact a three-dimensional hyperplane. Up and down still exist, and there is gravity, apparently.

As far as one can see, the hyperplane extends infinitely in all six directions.

On the readout of the mystic compass floats a set of ethereal symbols:  :  : 

In the middle distance is some kind of structure, roughly to the northwest.

>b
Agent Faraji is on a featureless hyperplane. In addition to the usual directions of north and south and east and west, two new directions exist here: back and forth. As a result, the "surface" they're standing on is in fact a three-dimensional hyperplane. Up and down still exist, and there is gravity, apparently.

As far as one can see, the hyperplane extends infinitely in all six directions.

On the readout of the mystic compass floats a set of ethereal symbols:  :  : 

In the middle distance is some kind of structure, roughly to the forthnorth.

>b
Agent Faraji is at the top of a descending stair. It is made of the same gossamer, questionably real stuff as the ground, the pillar, and the readouts. You can't see past the first turn of the stairs, unfortunately.

On the readout of the mystic compass floats a set of ethereal symbols:  :  : 

In the middle distance is some kind of structure, roughly to the forthnorth.

>d
Agent Faraji is at field office reception. Hooray you made it!

Also here is Maggie.

>w
Agent Faraji is in the field office hallway. Hallway

>w
Agent Faraji is in the field office chief's office. Doris's office

Doris is sitting cross-legged in a chair, tapping his foot lazily on the desk.

"Ah, Larch," Doris exclaims, standing up to shake their hand. "I've been waiting for you to pay us a visit. Did you bring the thumb drive?"

Faraji can ask who he is, ask where we are, ask how to get home or ask what thumb drive.

>what thumb drive
Faraji looks quizzical. "What thumb drive?"

"Huh. Thought you would have found it by now. I'm almost certain it's in your Swamp Park office. Go find it and bring it here." Doris busies himself at his desk, pointedly ignoring you.

Faraji can ask who he is, ask where we are or ask how to get home.

>purloin thumb drive
Which do you mean, they don't have it, what thumb drive, show him the thumb drive, hand over the thumb drive or the thumb drive?

>gonear front office
Agent Faraji is in the front office. It's really a small storefront done up to resemble an office. A store sales counter serves as a front desk, behind which are located shelves of office supplies and a row of drawers. There are also a couch and coffee table here creating a makeshift seating area. An old department store clothing rack serves as a coatrack. Photos on the walls picture the Bureau in better days. A stack of used and empty cardboard boxes sits in one corner.

The Bureau's latest office manager, Margaret is bustling around with unrestrained enthusiasm, unpacking boxes and assembling an approximation of a respectable front office, all as if the Bureau isn't going to be shut down before the year is out. She sees Faraji and practically squeals. "Agent Faraji! I'm sorry -- Larch! How are you? I hope you don't mind -- I took the liberty of putting your desk together. I just love hex wrenches, don't you? Also, your new phone is here. I put it in your desk. Good timing! Now I just need you to give me your old phone so I can deactivate it."

Faraji hands Margaret their old phone. Margaret taps a few keys on her computer and says "There! All settled."

"Oh, good", Faraji says. "Our phone downgrades have arrived from our bureaucratic betters."

Faraji can ask who he is, ask where we are or ask how to get home.

A phone is ringing not too far away.

Faraji can ask who he is, ask where we are or ask how to get home.

>hi
(addressing Margaret)
A phone is ringing not too far away.

>look behind desk
There are a number of shelves of office supplies behind the desk. There is also a heating vent on the floor here.

Faraji finds their computer and pulls it out.

A phone is ringing not too far away.

>x computer
Faraji's computer has been damaged beyond repair. But they do find a thumb drive and take it.

A phone is ringing not too far away.

Faraji can remember finding the drive.

>gonear doris
Agent Faraji is in the field office chief's office. Doris's office

Doris is sitting cross-legged in a chair, tapping his foot lazily on the desk.

>z
Faraji stands around and waits.

>show thumb drive to doris
Faraji answers, "Yes, I have it."

"Fantastic! Hand it here."

Faraji can ask who he is, ask where we are, ask how to get home or hand over the thumb drive.

>hand it over
Faraji gives the thumb drive to Doris.

"Great, great." He peruses the drive. "We lost one of our New York agents to a slingshot effect that threw him far back in time. We're always monitoring for artifacts that are out of place or anachronistic to lead us to lost agents.

He continues, "The scratch marks here say, 'They found me out and sent me back. 14th century. Enigma Lake. Savra is going to move on the Dragon.'"

Faraji can ask who he is, ask where we are, ask how to get home, ask about Savra, ask about the Dragon or ask about time travel.

>ask about time travel
Disbelievingly, Faraji asks, "Time travel? For real?"

"Yes, yes," Doris responds. "Don't get too worked up over it. It gets old fast."

Faraji can ask who he is, ask where we are, ask how to get home, ask about Savra, ask about the mission or ask about the Dragon.

>as about the mission
I'm not sure what you're trying to say. I might just not recognize the words you're using.

>asm about the mission
I'm not sure what you're trying to say. I might just not recognize the words you're using.

>ask about the mission
"Fine," Faraji says. "What's the mission?"

Doris leans back in his chair. "I believe we still have a chance to retrieve our lost agent -- the one that left the thumb drive. He says he was at Enigma Lake, not far from where you found the drive. Now it makes sense that Daniels -- the agent -- would head for some kind of landmark so we could find him, and indeed there is a prominent intersection of leylines in the middle of the lake. Before you say it, yes it's a problem, if that intersection had always been underwater. But Enigma Lake is an artificial reservoir. The town of Enigma Lake was flooded when the reservoir was created, and that's where the intersection is!" Doris concludes with a look of satisfaction.

"So..." Faraji says.

"So. I'm sending you back to 1954, right before the flooding of Enigma Lake, and you'll find whatever Daniels left for us to find. Maybe we can stage a rescue. Why 1954? I'd rather not risk a longer temporal jaunt before we know what we're dealing with."

Faraji can ask who he is, ask where we are, ask how to get home, ask about Savra, ask about the Dragon or ask how will i find him.

>how will i find
"How am I going to find him? Didn't he leave that message in the fourteenth century?"

Doris looks exasperated. "Well I don't know -- Improvise, use the power of the leylines, look around for anything that looks like it might be a time portal. Something like that. Let's see if the DC office can impress me. Let me know when you're ready to go."

Faraji can ask who he is, ask where we are, ask how to get home, ask about Savra, ask about the Dragon or tell Doris they're ready to go.

>ready to go
Squaring their shoulders, Faraji says, "Ready to go."

Doris grins. "Great! First, you'll need this." He hands you a small device. "In case you need to come back for any reason, press this button and you'll come back here. Do not abuse this for trivial matters! Time travel consumes valuable resources. Now go. Out of my office and to the forth you'll find the portal room. It's all ready to send you where you need to go."

Faraji can ask who he is, ask where we are, ask how to get home, ask about Savra or ask about the Dragon.

>e
Agent Faraji is in the field office hallway. Hallway

>f
Agent Faraji is in Portal Room 1. 

Also here is a portal to the past.

>enter portal
Faraji enters the field of light, and suddenly is somewhere else.

Agent Faraji is in the Enigma Lake town hall.

>n
Agent Faraji is in Enigma Park.

>n
Agent Faraji is on the lake shore north of the park.

>s
Agent Faraji is in Enigma Park.

>s
Agent Faraji is in the Enigma Lake town hall.

>s
Agent Faraji is on the 200 block of Main Street.

* * *

>turn on light
Faraji switches the light switch on.

Agent Faraji is in the back basement. The basement ends here. There is a switch on the wall, currently on. A doorway leads north.

A strange glow emanates from behind some stacks of large crates.

Also here is a handtruck.

>turn on switch
There's nothing like that nearby.

>turn light on
There's nothing like that nearby.

>switch light on
There's nothing like that nearby.

>switch
What do you want to switch?

>switch
What do you want to switch?

>switch switch
There's nothing like that nearby.

>switch light switch
There's nothing like that nearby.

* * *

>gonear back basement
Agent Faraji is in the back basement. The basement ends here. There is a switch on the wall, currently on. A doorway leads north.

A strange glow emanates from behind some stacks of large crates.

>turn off light
Faraji switches the light switch off.

It is now pitch dark in here!

>turn on light
Faraji switches the light switch on.

Agent Faraji is in the back basement. The basement ends here. There is a switch on the wall, currently on. A doorway leads north.

A strange glow emanates from behind some stacks of large crates.

>turn off light
Faraji switches the light switch off.

It is now pitch dark in here!

>l
Agent Faraji is in the dark. Some light would be nice.

There is a glow-in-the-dark light switch on the wall here, currently off.

There is a strange glow emanating from behind some large dark objects.

>turn on light
Faraji switches the light switch on.

Agent Faraji is in the back basement. The basement ends here. There is a switch on the wall, currently on. A doorway leads north.

A strange glow emanates from behind some stacks of large crates.

>z
Faraji stands around and waits.

>z
Faraji stands around and waits.

>x glow
The glow is blue-white and flickering.

* * *

>gonear basement
Which do you mean, the laundromat basement, the back basement, the Book Store Basement, the gym basement or the gymnasium basement door?

>book store
Agent Faraji is in the Book Store Basement.

* * *

>remove lenses
Faraji takes off the pair of astral lenses.

>n
Agent Faraji is in a sewer tunnel.

>e
Agent Faraji is in a sewer tunnel.

>wear lenses
Faraji puts on the pair of astral lenses.

>e
Agent Faraji is in a sewer tunnel. 

A strange sparkly white passage branches off in an impossible direction from here.

Faraji has discovered a hyperspatial tunnel! It leads in the hyperspatial direction of "forth".
For help regarding hyperspace, enter HELP HYPERSPACE.

* * *

>gonear chief's office
Which do you mean, the field office chief's office or the BOSH chief's office?

>bosh
Agent Faraji is in the BOSH chief's office. Looks like the Chief has already moved in.

Chief Klimp's office is full of character. Shelves strewn with knick-knacks abut a cozy armchair and a mahogany side table supporting a large globe. A bookcase on the north wall is packed with books on paranormal happenings. Garish prints adorn the remaining wall space.  Under one of these is a modernistic desk of glass and chrome, behind which is a very nice black leather swivel chair. There is a computer on the desk, and to its side is an antique wooden file cabinet. To tell the truth, it's all a bit much, but it matches Klimp's personality perfectly. There is an exit to the east.

On the Chief's shelves are a juvenile sasquatch skull and a pair of astral lenses.

>take lenses
That belongs to Chief Klimp.

* * *

>gonear doris
Agent Faraji is in the field office chief's office. Doris's office

Doris is sitting cross-legged in a chair, tapping his foot lazily on the desk.

"Ah, Larch," Doris exclaims, standing up to shake their hand. "I've been waiting for you to pay us a visit. Did you bring the thumb drive?"

>hi
(addressing Doris)
Faraji can ask who he is, ask where we are, ask how to get home or ask what thumb drive.

>what drive
Faraji looks quizzical. "What thumb drive?"

"Huh. Thought you would have found it by now. I'm almost certain it's in your Swamp Park office. Go find it and bring it here." Doris busies himself at his desk, pointedly ignoring you.

Faraji can ask who he is, ask where we are or ask how to get home.

>gonear front office
Agent Faraji is in the front office. It's really a small storefront done up to resemble an office. A store sales counter serves as a front desk, behind which are located shelves of office supplies and a row of drawers. There are also a couch and coffee table here creating a makeshift seating area. An old department store clothing rack serves as a coatrack. Photos on the walls picture the Bureau in better days. A stack of used and empty cardboard boxes sits in one corner.

The Bureau's latest office manager, Margaret is bustling around with unrestrained enthusiasm, unpacking boxes and assembling an approximation of a respectable front office, all as if the Bureau isn't going to be shut down before the year is out. She sees Faraji and practically squeals. "Agent Faraji! I'm sorry -- Larch! How are you? I hope you don't mind -- I took the liberty of putting your desk together. I just love hex wrenches, don't you? Also, your new phone is here. I put it in your desk. Good timing! Now I just need you to give me your old phone so I can deactivate it."

Faraji hands Margaret their old phone. Margaret taps a few keys on her computer and says "There! All settled."

"Oh, good", Faraji says. "Our phone downgrades have arrived from our bureaucratic betters."

Faraji can ask who he is, ask where we are or ask how to get home.

A phone is ringing not too far away.

Faraji can ask who he is, ask where we are or ask how to get home.

* * *

>gonear doris
Agent Faraji is in the field office chief's office. Doris's office

Doris is sitting cross-legged in a chair, tapping his foot lazily on the desk.

>hi
(addressing Doris)
Faraji can ask who he is, ask where we are, ask how to get home or show him the thumb drive.

>show him the thumb drive
Faraji answers, "Yes, I have it."

"Fantastic! Hand it here."

Faraji can ask who he is, ask where we are, ask how to get home or hand over the thumb drive.

>hand ir over
I'm not sure what you're trying to say. I might just not recognize the words you're using.

>hand it over
Faraji gives the thumb drive to Doris.

"Great, great." He peruses the drive. "We lost one of our New York agents to a slingshot effect that threw him far back in time. We're always monitoring for artifacts that are out of place or anachronistic to lead us to lost agents.

He continues, "The scratch marks here say, 'They found me out and sent me back. 14th century. Enigma Lake. Savra is going to move on the Dragon.'"

Faraji can ask who he is, ask where we are, ask how to get home, ask about Savra, ask about the Dragon or ask about time travel.

>ask about savra
"Senator Savra? What does he have to with anything?" Faraji asks.

Doris says, "Well you've noticed he's not very friendly to the Bureau? Let's leave it at that for now. We need to talk about the mission."

Faraji can ask who he is, ask where we are, ask how to get home, ask about the mission, ask about the Dragon or ask about time travel.

>what about the dragon
Faraji says, "Who is this 'Dragon'?"

Doris brings his finger to his lips. "Classified. Need to know only."

Faraji can ask who he is, ask where we are, ask how to get home, ask about the mission or ask about time travel.

>ask about time travel
Disbelievingly, Faraji asks, "Time travel? For real?"

"Yes, yes," Doris responds. "Don't get too worked up over it. It gets old fast."

Faraji can ask who he is, ask where we are, ask how to get home or ask about the mission.

>ask how to get home
Faraji asks, "Just how can I get home from here?"

"Go ask Maggie; she can help you."

Faraji can ask who he is, ask where we are or ask about the mission.

>ask about the mission
"Fine," Faraji says. "What's the mission?"

Doris leans back in his chair. "I believe we still have a chance to retrieve our lost agent -- the one that left the thumb drive. He says he was at Enigma Lake, not far from where you found the drive. Now it makes sense that Daniels -- the agent -- would head for some kind of landmark so we could find him, and indeed there is a prominent intersection of leylines in the middle of the lake. Before you say it, yes it's a problem, if that intersection had always been underwater. But Enigma Lake is an artificial reservoir. The town of Enigma Lake was flooded when the reservoir was created, and that's where the intersection is!" Doris concludes with a look of satisfaction.

"So..." Faraji says.

"So. I'm sending you back to 1954, right before the flooding of Enigma Lake, and you'll find whatever Daniels left for us to find. Maybe we can stage a rescue. Why 1954? I'd rather not risk a longer temporal jaunt before we know what we're dealing with."

Faraji can ask who he is, ask where we are or ask how will i find him.

>how will i find him
"How am I going to find him? Didn't he leave that message in the fourteenth century?"

Doris looks exasperated. "Well I don't know -- Improvise, use the power of the leylines, look around for anything that looks like it might be a time portal. Something like that. Let's see if the DC office can impress me. Let me know when you're ready to go."

Faraji can ask who he is, ask where we are or tell Doris they're ready to go.

>ready to go
Squaring their shoulders, Faraji says, "Ready to go."

Doris grins. "Great! First, you'll need this." He hands you a small device. "In case you need to come back for any reason, press this button and you'll come back here. Do not abuse this for trivial matters! Time travel consumes valuable resources. Now go. Out of my office and to the forth you'll find the portal room. It's all ready to send you where you need to go."

Faraji can ask who he is or ask where we are.

>e
Agent Faraji is in the field office hallway. Hallway

* * *

>gonear doris
Agent Faraji is in the field office chief's office. Doris's office

Doris is sitting cross-legged in a chair, tapping his foot lazily on the desk.

"Ah, Larch," Doris exclaims, standing up to shake their hand. "I've been waiting for you to pay us a visit. Did you bring the thumb drive?"

>l
Agent Faraji is in the field office chief's office. Doris's office

Doris is sitting cross-legged in a chair, tapping his foot lazily on the desk.

>w
Faraji can't go that way.

>e
Agent Faraji is in the field office hallway. Hallway

>w
Agent Faraji is in the field office chief's office. Doris's office

Doris is sitting cross-legged in a chair, tapping his foot lazily on the desk.

Faraji can ask who he is, ask where we are, ask how to get home or ask what thumb drive.

>what thumb drive
Faraji looks quizzical. "What thumb drive?"

"Huh. Thought you would have found it by now. I'm almost certain it's in your Swamp Park office. Go find it and bring it here." Doris busies himself at his desk, pointedly ignoring you.

Faraji can ask who he is, ask where we are or ask how to get home.

>gonear bosh front office
There seems to be no such object anywhere in the model world.

>gonear front office
Agent Faraji is in the front office. It's really a small storefront done up to resemble an office. A store sales counter serves as a front desk, behind which are located shelves of office supplies and a row of drawers. There are also a couch and coffee table here creating a makeshift seating area. An old department store clothing rack serves as a coatrack. Photos on the walls picture the Bureau in better days. A stack of used and empty cardboard boxes sits in one corner.

The Bureau's latest office manager, Margaret is bustling around with unrestrained enthusiasm, unpacking boxes and assembling an approximation of a respectable front office, all as if the Bureau isn't going to be shut down before the year is out. She sees Faraji and practically squeals. "Agent Faraji! I'm sorry -- Larch! How are you? I hope you don't mind -- I took the liberty of putting your desk together. I just love hex wrenches, don't you? Also, your new phone is here. I put it in your desk. Now I just need you to give me your old phone so I can deactivate it."

Faraji hands Margaret their old phone. Margaret taps a few keys on her computer and says "There! All settled."

"Oh, good", Faraji says. "Our phone downgrades have arrived from our bureaucratic betters."

Faraji can ask who he is, ask where we are or ask how to get home.

A phone is ringing not too far away.

Faraji can ask who he is, ask where we are or ask how to get home.

>look behind desk
There are a number of shelves of office supplies behind the desk. There is also a heating vent on the floor here.

Faraji finds their computer and pulls it out.

A phone is ringing not too far away.

Faraji can ask who he is, ask where we are or ask how to get home.

>x computer
Faraji's computer has been damaged beyond repair. But they do find a thumb drive and take it.

A phone is ringing not too far away.

Faraji can remember finding the drive. They can ask who he is, ask where we are, ask how to get home or show him the thumb drive.

>gonear field office hall
There seems to be no such object anywhere in the model world.

>gonear field office hallway
Agent Faraji is in the field office hallway. Hallway

Faraji can ask who he is, ask where we are, ask how to get home or show him the thumb drive.

Faraji can ask who he is, ask where we are, ask how to get home or show him the thumb drive.

>w
Agent Faraji is in the field office chief's office. Doris's office

Doris is sitting cross-legged in a chair, tapping his foot lazily on the desk.

Faraji can ask who he is, ask where we are, ask how to get home or show him the thumb drive.

Faraji can ask who he is, ask where we are, ask how to get home or show him the thumb drive.

>show him thumb drive
Faraji answers, "Yes, I have it."

"Fantastic! Hand it here."

Faraji can ask who he is, ask where we are, ask how to get home or hand over the thumb drive.

>e
Agent Faraji is in the field office hallway. Hallway

>drop drive
Dropped.

>w
Agent Faraji is in the field office chief's office. Doris's office

Doris is sitting cross-legged in a chair, tapping his foot lazily on the desk.

Faraji can ask who he is, ask where we are, ask how to get home or hand over the thumb drive.

>hand it over
Faraji doesn't have the thumb drive.

Faraji can ask who he is, ask where we are, ask how to get home or hand over the thumb drive.

>purloin it
Which do you mean, they don't have it or hand over the thumb drive?

>s
I only understood you as far as wanting to purloin south.

>w
Faraji can't go that way.

Faraji can ask who he is, ask where we are, ask how to get home or hand over the thumb drive.

>e
Agent Faraji is in the field office hallway. Hallway

Also here is a thumb drive.

>take
(the thumb drive)
Taken.

>w
Agent Faraji is in the field office chief's office. Doris's office

Doris is sitting cross-legged in a chair, tapping his foot lazily on the desk.

Faraji can ask who he is, ask where we are, ask how to get home or hand over the thumb drive.

>hand over
Faraji gives the thumb drive to Doris.

"Great, great." He peruses the drive. "We lost one of our New York agents to a slingshot effect that threw him far back in time. We're always monitoring for artifacts that are out of place or anachronistic to lead us to lost agents.

He continues, "The scratch marks here say, 'They found me out and sent me back. 14th century. Enigma Lake. Savra is going to move on the Dragon.'"

Faraji can ask who he is, ask where we are, ask how to get home, ask about Savra, ask about the Dragon or ask about time travel.

* * *

>gonear gym basement
Agent Faraji is in the gym basement. This area is dominated by large banks of lockers.

>open 3
Faraji doesn't have a key for the locker.

>open 1
Faraji doesn't have a key for the locker.

>open 345
Faraji doesn't have a key for the locker.

>open -1
Faraji doesn't have a key for the locker.

>open 0
Faraji doesn't have a key for the locker.

>purloin locker key
[Purloined.]

>open 0
The lockers are numbered 1 to 100.

>open 345
The lockers are numbered 1 to 100.

>open 1
The key doesn't fit the lock.

Faraji opens the locker. It contains some dirty gym clothes, among which you find an old copper key. They take it and close the locker.

>u
Agent Faraji is in the public gymnasium. There is a basketball court and a weight training area. A front desk is next to the front entrance.

>w
Agent Faraji is in Lake Street by the gym.

>w
Faraji can't go that way.

>n
Agent Faraji is in Lake Street by the Park.

>w
Agent Faraji is in Enigma Park.

>s
Agent Faraji is in the Enigma Lake town hall.

>w
Faraji can't go that way.

>w
Faraji can't go that way.

>b
Faraji can't go that way.

>n
Agent Faraji is in Enigma Park.

* * *

>n
Agent Faraji is on the lake shore north of the park.

>w
Agent Faraji is at the west end of the town's lake shore.

>unlock door
There's nothing like that nearby.

>old key
I'm not sure what you're trying to say. I might just not recognize the words you're using.

>i
Faraji is carrying:
  an old copper key
  a locker key
  the Bureau credit card
  a green smartphone

>w
Faraji can't go that way.

* * *

>gonear gymnasium
Agent Faraji is in the public gymnasium. There is a basketball court and a weight training area. A front desk is next to the front entrance.

On the gym front desk is a membership book.

>read book
It's a book apparently full of records of the members of the gym. You could LOOK UP a member's name IN BOOK.

>look up thoma in book
You can't find that name in the membership book.

>look up thompson in book
WILLIAM THOMPSON
 126 Rochester Road
 Enigma Lake, NY
 #10.

>look up bill thompson in book
WILLIAM THOMPSON
 126 Rochester Road
 Enigma Lake, NY
 #10.

>look up william thompson in book
WILLIAM THOMPSON
 126 Rochester Road
 Enigma Lake, NY
 #10.

>consult book about william thompson
WILLIAM THOMPSON
 126 Rochester Road
 Enigma Lake, NY
 #10.

>d
Agent Faraji is in the gym basement. This area is dominated by large banks of lockers.

* * *

>gonear hyperplane
Agent Faraji is on a featureless hyperplane. They rub their eyes as they try to take in their surroundings. In addition to the usual directions of north and south and east and west, two new directions exist here: back and forth. As a result, the "surface" they're standing on is in fact a three-dimensional hyperplane. Up and down still exist, and there is gravity, apparently.

As far as one can see, the hyperplane extends infinitely in all six directions.

In the middle distance is some kind of structure, roughly to the forth.

>f
Agent Faraji is on a featureless hyperplane. In addition to the usual directions of north and south and east and west, two new directions exist here: back and forth. As a result, the "surface" they're standing on is in fact a three-dimensional hyperplane. Up and down still exist, and there is gravity, apparently.

As far as one can see, the hyperplane extends infinitely in all six directions.

In the middle distance is some kind of structure, roughly to the forth.

* * *

>fn
Agent Faraji is on a featureless hyperplane. In addition to the usual directions of north and south and east and west, two new directions exist here: back and forth. As a result, the "surface" they're standing on is in fact a three-dimensional hyperplane. Up and down still exist, and there is gravity, apparently.

As far as one can see, the hyperplane extends infinitely in all six directions.

Close by is some kind of structure to the west.

>w
Agent Faraji is next to an ethereal pillar. In addition to the usual directions of north and south and east and west, two new directions exist here: back and forth. As a result, the "surface" they're standing on is in fact a three-dimensional hyperplane. Up and down still exist, and there is gravity, apparently.

As far as one can see, the hyperplane extends infinitely in all six directions.

There is an ethereal pillar here. A message carved into the pillar says "Seek the origin. -Doris"

Under that is a line of five strange symbols: o p q d b

A mystic compass dangles from an outcropping of the pillar.

Also here is an Ethereal Pillar.

>take compass
Taken.

>read it
On the readout of the mystic compass floats a set of ethereal symbols: pq : pd : pb

>s
Agent Faraji is on a featureless hyperplane. In addition to the usual directions of north and south and east and west, two new directions exist here: back and forth. As a result, the "surface" they're standing on is in fact a three-dimensional hyperplane. Up and down still exist, and there is gravity, apparently.

As far as one can see, the hyperplane extends infinitely in all six directions.

On the readout of the mystic compass floats a set of ethereal symbols: pp : pd : pb

Close by is some kind of structure to the north.

>s
Agent Faraji is on a featureless hyperplane. In addition to the usual directions of north and south and east and west, two new directions exist here: back and forth. As a result, the "surface" they're standing on is in fact a three-dimensional hyperplane. Up and down still exist, and there is gravity, apparently.

As far as one can see, the hyperplane extends infinitely in all six directions.

On the readout of the mystic compass floats a set of ethereal symbols: po : pd : pb

Not too far off is some kind of structure, roughly to the north.

>s
Agent Faraji is on a featureless hyperplane. In addition to the usual directions of north and south and east and west, two new directions exist here: back and forth. As a result, the "surface" they're standing on is in fact a three-dimensional hyperplane. Up and down still exist, and there is gravity, apparently.

As far as one can see, the hyperplane extends infinitely in all six directions.

On the readout of the mystic compass floats a set of ethereal symbols: b : pd : pb

Not too far off is some kind of structure, roughly to the north.

>s
Agent Faraji is on a featureless hyperplane. In addition to the usual directions of north and south and east and west, two new directions exist here: back and forth. As a result, the "surface" they're standing on is in fact a three-dimensional hyperplane. Up and down still exist, and there is gravity, apparently.

As far as one can see, the hyperplane extends infinitely in all six directions.

On the readout of the mystic compass floats a set of ethereal symbols: d : pd : pb

Not too far off is some kind of structure, roughly to the north.

>s
Agent Faraji is on a featureless hyperplane. In addition to the usual directions of north and south and east and west, two new directions exist here: back and forth. As a result, the "surface" they're standing on is in fact a three-dimensional hyperplane. Up and down still exist, and there is gravity, apparently.

As far as one can see, the hyperplane extends infinitely in all six directions.

On the readout of the mystic compass floats a set of ethereal symbols: q : pd : pb

Not too far off is some kind of structure, roughly to the north.

>s
Agent Faraji is on a featureless hyperplane. In addition to the usual directions of north and south and east and west, two new directions exist here: back and forth. As a result, the "surface" they're standing on is in fact a three-dimensional hyperplane. Up and down still exist, and there is gravity, apparently.

As far as one can see, the hyperplane extends infinitely in all six directions.

On the readout of the mystic compass floats a set of ethereal symbols: p : pd : pb

Not too far off is some kind of structure, roughly to the north.

>s
Agent Faraji is on a featureless hyperplane. In addition to the usual directions of north and south and east and west, two new directions exist here: back and forth. As a result, the "surface" they're standing on is in fact a three-dimensional hyperplane. Up and down still exist, and there is gravity, apparently.

As far as one can see, the hyperplane extends infinitely in all six directions.

On the readout of the mystic compass floats a set of ethereal symbols: o : pd : pb

Not too far off is some kind of structure, roughly to the north.

>e
Agent Faraji is on a featureless hyperplane. In addition to the usual directions of north and south and east and west, two new directions exist here: back and forth. As a result, the "surface" they're standing on is in fact a three-dimensional hyperplane. Up and down still exist, and there is gravity, apparently.

As far as one can see, the hyperplane extends infinitely in all six directions.

On the readout of the mystic compass floats a set of ethereal symbols: o : pq : pb

Not too far off is some kind of structure, roughly to the north.

>e
Agent Faraji is on a featureless hyperplane. In addition to the usual directions of north and south and east and west, two new directions exist here: back and forth. As a result, the "surface" they're standing on is in fact a three-dimensional hyperplane. Up and down still exist, and there is gravity, apparently.

As far as one can see, the hyperplane extends infinitely in all six directions.

On the readout of the mystic compass floats a set of ethereal symbols: o : pp : pb

Not too far off is some kind of structure, roughly to the north.

>e
Agent Faraji is on a featureless hyperplane. In addition to the usual directions of north and south and east and west, two new directions exist here: back and forth. As a result, the "surface" they're standing on is in fact a three-dimensional hyperplane. Up and down still exist, and there is gravity, apparently.

As far as one can see, the hyperplane extends infinitely in all six directions.

On the readout of the mystic compass floats a set of ethereal symbols: o : po : pb

Not too far off is some kind of structure, roughly to the north.

>e
Agent Faraji is on a featureless hyperplane. In addition to the usual directions of north and south and east and west, two new directions exist here: back and forth. As a result, the "surface" they're standing on is in fact a three-dimensional hyperplane. Up and down still exist, and there is gravity, apparently.

As far as one can see, the hyperplane extends infinitely in all six directions.

On the readout of the mystic compass floats a set of ethereal symbols: o : b : pb

Not too far off is some kind of structure, roughly to the northwest.

>e
Agent Faraji is on a featureless hyperplane. In addition to the usual directions of north and south and east and west, two new directions exist here: back and forth. As a result, the "surface" they're standing on is in fact a three-dimensional hyperplane. Up and down still exist, and there is gravity, apparently.

As far as one can see, the hyperplane extends infinitely in all six directions.

On the readout of the mystic compass floats a set of ethereal symbols: o : d : pb

Not too far off is some kind of structure, roughly to the northwest.

>e
Agent Faraji is on a featureless hyperplane. In addition to the usual directions of north and south and east and west, two new directions exist here: back and forth. As a result, the "surface" they're standing on is in fact a three-dimensional hyperplane. Up and down still exist, and there is gravity, apparently.

As far as one can see, the hyperplane extends infinitely in all six directions.

On the readout of the mystic compass floats a set of ethereal symbols: o : q : pb

Not too far off is some kind of structure, roughly to the northwest.

>e
Agent Faraji is on a featureless hyperplane. In addition to the usual directions of north and south and east and west, two new directions exist here: back and forth. As a result, the "surface" they're standing on is in fact a three-dimensional hyperplane. Up and down still exist, and there is gravity, apparently.

As far as one can see, the hyperplane extends infinitely in all six directions.

On the readout of the mystic compass floats a set of ethereal symbols: o : p : pb

In the middle distance is some kind of structure, roughly to the northwest.

>e
Agent Faraji is on a featureless hyperplane. In addition to the usual directions of north and south and east and west, two new directions exist here: back and forth. As a result, the "surface" they're standing on is in fact a three-dimensional hyperplane. Up and down still exist, and there is gravity, apparently.

As far as one can see, the hyperplane extends infinitely in all six directions.

On the readout of the mystic compass floats a set of ethereal symbols: o : o : pb

In the middle distance is some kind of structure, roughly to the northwest.

>b
Agent Faraji is on a featureless hyperplane. In addition to the usual directions of north and south and east and west, two new directions exist here: back and forth. As a result, the "surface" they're standing on is in fact a three-dimensional hyperplane. Up and down still exist, and there is gravity, apparently.

As far as one can see, the hyperplane extends infinitely in all six directions.

On the readout of the mystic compass floats a set of ethereal symbols: o : o : pd

In the middle distance is some kind of structure, roughly to the northwest.

>b
Agent Faraji is on a featureless hyperplane. In addition to the usual directions of north and south and east and west, two new directions exist here: back and forth. As a result, the "surface" they're standing on is in fact a three-dimensional hyperplane. Up and down still exist, and there is gravity, apparently.

As far as one can see, the hyperplane extends infinitely in all six directions.

On the readout of the mystic compass floats a set of ethereal symbols: o : o : pq

In the middle distance is some kind of structure, roughly to the northwest.

>b
Agent Faraji is on a featureless hyperplane. In addition to the usual directions of north and south and east and west, two new directions exist here: back and forth. As a result, the "surface" they're standing on is in fact a three-dimensional hyperplane. Up and down still exist, and there is gravity, apparently.

As far as one can see, the hyperplane extends infinitely in all six directions.

On the readout of the mystic compass floats a set of ethereal symbols: o : o : pp

In the middle distance is some kind of structure, roughly to the northwest.

>b
Agent Faraji is on a featureless hyperplane. In addition to the usual directions of north and south and east and west, two new directions exist here: back and forth. As a result, the "surface" they're standing on is in fact a three-dimensional hyperplane. Up and down still exist, and there is gravity, apparently.

As far as one can see, the hyperplane extends infinitely in all six directions.

On the readout of the mystic compass floats a set of ethereal symbols: o : o : po

In the middle distance is some kind of structure, roughly to the northwest.

>b
Agent Faraji is on a featureless hyperplane. In addition to the usual directions of north and south and east and west, two new directions exist here: back and forth. As a result, the "surface" they're standing on is in fact a three-dimensional hyperplane. Up and down still exist, and there is gravity, apparently.

As far as one can see, the hyperplane extends infinitely in all six directions.

On the readout of the mystic compass floats a set of ethereal symbols: o : o : b

In the middle distance is some kind of structure, roughly to the northwest.

>b
Agent Faraji is on a featureless hyperplane. In addition to the usual directions of north and south and east and west, two new directions exist here: back and forth. As a result, the "surface" they're standing on is in fact a three-dimensional hyperplane. Up and down still exist, and there is gravity, apparently.

As far as one can see, the hyperplane extends infinitely in all six directions.

On the readout of the mystic compass floats a set of ethereal symbols: o : o : d

In the middle distance is some kind of structure, roughly to the northwest.

>b
Agent Faraji is on a featureless hyperplane. In addition to the usual directions of north and south and east and west, two new directions exist here: back and forth. As a result, the "surface" they're standing on is in fact a three-dimensional hyperplane. Up and down still exist, and there is gravity, apparently.

As far as one can see, the hyperplane extends infinitely in all six directions.

On the readout of the mystic compass floats a set of ethereal symbols: o : o : q

In the middle distance is some kind of structure, roughly to the northwest.

>b
Agent Faraji is on a featureless hyperplane. In addition to the usual directions of north and south and east and west, two new directions exist here: back and forth. As a result, the "surface" they're standing on is in fact a three-dimensional hyperplane. Up and down still exist, and there is gravity, apparently.

As far as one can see, the hyperplane extends infinitely in all six directions.

On the readout of the mystic compass floats a set of ethereal symbols: o : o : p

In the middle distance is some kind of structure, roughly to the forthnorth.

>b
Agent Faraji is at the top of a descending stair. It is made of the same gossamer, questionably real stuff as the ground, the pillar, and the readouts. You can't see past the first turn of the stairs, unfortunately.

On the readout of the mystic compass floats a set of ethereal symbols: o : o : o

In the middle distance is some kind of structure, roughly to the forthnorth.

>d
Agent Faraji is at field office reception. Hooray you made it!

Also here is Maggie.

>x maggie
There seems to be nothing special about her.

* * *

>gonear lake at ridge
Agent Faraji is at the intersection of Lake Street and Ridge Road. The intersection lies at the edge of the lake. Lake Street runs south into town, while Ridge Road heads off into the darkness east of here. A little park along the lake shore is to the west.

There is an abandoned pickup truck at the side of the road.

>open truck
Faraji opens the abandoned pickup truck, revealing nothing.

>enter it
Faraji gets into the abandoned truck.

>l
Agent Faraji is in Lake at Ridge. They are in the abandoned truck. The intersection lies at the edge of the lake. Lake Street runs south into town, while Ridge Road runs off into the darkness east of here. The lake shore park is to the west.

>x glove compartment
There seems to be nothing special about it.

>open it
Faraji opens the glove compartment, revealing a set of keys.

>take keys
Taken.

* * *

>open truck
Faraji opens the abandoned pickup truck, revealing nothing.

>enter truck
Agent Faraji is at the intersection of Lake Street and Ridge Road. They are in the abandoned pickup truck. There is a glove compartment on the passenger side, closed.

The intersection lies at the edge of the lake. Lake Street runs south into town, while Ridge Road heads off into the darkness east of here. A little park along the lake shore is to the west.

>l
Agent Faraji is at the intersection of Lake Street and Ridge Road. They are in the abandoned pickup truck. There is a glove compartment on the passenger side, closed.

The intersection lies at the edge of the lake. Lake Street runs south into town, while Ridge Road heads off into the darkness east of here. A little park along the lake shore is to the west.

>open compartment
Faraji opens the glove compartment, revealing a brass key.

>l
Agent Faraji is at the intersection of Lake Street and Ridge Road. They are in the abandoned pickup truck. There is a glove compartment on the passenger side, open.

The intersection lies at the edge of the lake. Lake Street runs south into town, while Ridge Road heads off into the darkness east of here. A little park along the lake shore is to the west.

>take key
Taken.

>start truck
Your key doesn't fit the ignition.

>purloin little grey key
Which do you mean, about the whereabouts of the desk key or the little grey key?

>both
[Purloined.]
[Purloined.]

>start truck
None of the keys you have fits the ignition.

>i
Faraji is carrying:
  a little grey key
  about the whereabouts of the desk key
  a brass key
  the Bureau credit card
  a green smartphone

>x about the whereabouts
There seems to be nothing special about it.

>s
Faraji would have to get out of the abandoned pickup truck first.

>get out
Faraji gets out of the abandoned pickup truck.

Agent Faraji is at the intersection of Lake Street and Ridge Road. The intersection lies at the edge of the lake. Lake Street runs south into town, while Ridge Road heads off into the darkness east of here. A little park along the lake shore is to the west.

There is an abandoned pickup truck at the side of the road.

>s
Agent Faraji is in Lake Street by the Park.

>s
Agent Faraji is in Lake Street by the Courthouse.

>s
Agent Faraji is in Main at Lake.

>w
Agent Faraji is on the 200 block of Main Street.

>s
Agent Faraji is in Rolle's Department Store.

>n
Agent Faraji is on the 200 block of Main Street.

>w
Agent Faraji is at Main and Solvay.

>s
(first opening the Skillet door)
It seems to be locked.

>open door
It seems to be locked.

>open door with brass key
Faraji unlocks the Skillet door.

>s
(first opening the Skillet door)
Agent Faraji is in Henry's Hot Skillet.

* * *

>take key
Taken.

>take keys
There's nothing like that nearby.

>get out
Faraji gets out of the abandoned pickup truck.

Agent Faraji is at the intersection of Lake Street and Ridge Road. The intersection lies at the edge of the lake. Lake Street runs south into town, while Ridge Road heads off into the darkness east of here. A little park along the lake shore is to the west.

There is an abandoned pickup truck at the side of the road.

>enter
Agent Faraji is at the intersection of Lake Street and Ridge Road. They are in the abandoned pickup truck. There is a glove compartment on the passenger side, open.

The intersection lies at the edge of the lake. Lake Street runs south into town, while Ridge Road heads off into the darkness east of here. A little park along the lake shore is to the west.

>start truck
None of the keys you have fits the ignition.

>turn on truck
None of the keys you have fits the ignition.

>showme keys
There seems to be no such object anywhere in the model world.

>showme key
(the brass key)
brass key - thing
location: carried by Faraji in the abandoned pickup truck in the intersection of Lake Street and Ridge Road
singular-named, improper-named, unmarked for special listing; unlit, inedible, portable, handled, neuter, seen, familiar, quiet, background
list grouping key: none
printed name: "brass key"
printed plural name: none
indefinite article: none
most recent reference: nominal
third singular pronoun: It-pronoun
summary: none
description: none
initial appearance: none
dark description: none
hearability: very loud
volume: 0.0
price: $0
behind description: none
third-plural-pronoun: They-pronoun
possessive: none
portrait: Figure Null

>drop key
Dropped.

>turn on truck
Even if this thing runs, you don't have the key.

>take key
Taken.

>get out
Faraji gets out of the abandoned pickup truck.

Agent Faraji is at the intersection of Lake Street and Ridge Road. The intersection lies at the edge of the lake. Lake Street runs south into town, while Ridge Road heads off into the darkness east of here. A little park along the lake shore is to the west.

There is an abandoned pickup truck at the side of the road.

>i
Faraji is carrying:
  a brass key
  the Bureau credit card
  a green smartphone

* * *

>open truck
Faraji opens the abandoned pickup truck, revealing nothing.

>get in
Faraji gets into the abandoned truck.

>l
Agent Faraji is in Lake at Ridge. They are in the abandoned truck. The intersection lies at the edge of the lake. Lake Street runs south into town, while Ridge Road runs off into the darkness east of here. The lake shore park is to the west.

>open glove compartment
Faraji opens the glove compartment, revealing a set of keys.

* * *

>get in
Faraji gets into the abandoned truck.

>z
Faraji stands around and waits.

>l
Agent Faraji is in Lake at Ridge. They are in the abandoned truck. The intersection lies at the edge of the lake. Lake Street runs south into town, while Ridge Road runs off into the darkness east of here. The lake shore park is to the west.

>l
Agent Faraji is in Lake at Ridge. They are in the abandoned truck. The intersection lies at the edge of the lake. Lake Street runs south into town, while Ridge Road runs off into the darkness east of here. The lake shore park is to the west.

>z
Faraji stands around and waits.

* * *

>gonear lake street by
Which do you mean, Lake Street by the gym or Lake Street by the Park?

>the park
Agent Faraji is in Lake Street by the Park.

>e
Agent Faraji is in First Unitarian Church of Enigma Lake.

* * *

>w
Agent Faraji is in Lake Street by the Park.

>s
Agent Faraji is in Lake Street by the gym. 

Also here is a gym door.

>e
(first opening the gym door)
It seems to be locked.

>gonear gym desk
Agent Faraji is in the public gymnasium. There is a basketball court and a weight training area. A front desk is next to the front entrance.

On the gym front desk is a membership book.

Also here is a gym door.

>take book
You hardly need it, and it might useful to someone else.

>purloin book
[Purloined.]

>drop it
Dropped.

>take it
You hardly need it, and it might useful to someone else.

>gonear stackss
There seems to be no such object anywhere in the model world.

>gonear stacks
Agent Faraji is in the back basement. The basement ends here. There is a switch on the wall, currently on. A doorway leads north.

A strange glow emanates from behind some stacks of large crates.

>take stacks
Those are too heavy to take.

>take membership
There's nothing like that nearby.

>gonear gym desk
Agent Faraji is in the public gymnasium. There is a basketball court and a weight training area. A front desk is next to the front entrance.

Also here are a membership book and a gym door.

>take membership
You hardly need it, and it might useful to someone else.

* * *

>gonear public
Agent Faraji is in the public gymnasium. There is a basketball court and a weight training area. A front desk is next to the front entrance.

On the gym front desk is a membership book.

>read book
It's a book apparently full of records of the members of the gym. You could LOOK UP a member's name IN BOOK.

>look up thompson in booki
There's nothing like that nearby.

>look up thompson in book
WILLIAM THOMPSON
 126 Rochester Road
 Enigma Lake, NY
 #37.

>d
Agent Faraji is in the gym basement. This area is dominated by large banks of lockers.

>open 29
Faraji doesn't have a key for the locker.

>open 22
Faraji doesn't have a key for the locker.

>purloin red key
[Purloined.]

>open 29
The key doesn't fit the lock.

>undo
gym basement
[Previous turn undone.]

>open 22
The key doesn't fit the lock.

>open 31
The key doesn't fit the lock.

>i
Faraji is carrying:
  a red key
  the Bureau credit card
  a green smartphone

>open 37
Faraji opens the locker. It contains some dirty gym clothes, among which they find an old copper key. They take it and close the locker.

>bn
Faraji can't go that way.

>n
Faraji can't go that way.

>l
Agent Faraji is in the gym basement. This area is dominated by large banks of lockers.

* * *

>gonear reading
Agent Faraji is in the Reading Room. 

On the sales counter is the book Astral Secrets.

>d
Agent Faraji is in the Book Store Basement.

>n
Agent Faraji is in a sewer tunnel.

* * *

>e
Agent Faraji is in a sewer tunnel.

>e
Agent Faraji is in a sewer tunnel.

>e
Faraji can't go that way.

>n
(first opening the gymnasium basement door)
It seems to be locked.

>w
Agent Faraji is in a sewer tunnel.

>w
Agent Faraji is in a sewer tunnel.

>s
Agent Faraji is in the Book Store Basement.

I beg your pardon?

>n
Agent Faraji is in a sewer tunnel.

* * *

>e
Faraji can't go that way.

>f
Agent Faraji is in the astral tunnel. It is featureless white, or what passes for white here. It leads back and backnorth.

>drop lens
(first taking the pair of astral lenses off)
Dropped.

>wear it
(first taking the pair of astral lenses)
That belongs to Chief Klimp.

* * *

>e
Agent Faraji is in a sewer tunnel.

>lense
I'm not sure what you're trying to say. I might just not recognize the words you're using.

* * *

>l
Agent Faraji is in a sewer tunnel. 

A strange sparkly white passage branches off in an impossible direction from here.

Faraji has discovered a hyperspatial tunnel! It leads in the hyperspatial direction of "forth".
For help regarding hyperspace, enter HELP HYPERSPACE.

>e
Faraji can't go that way.

* * *

>f
Agent Faraji is in the astral tunnel. It is featureless white, or what passes for white here. It leads back and backnorth.

>bn
Agent Faraji is in the gym basement. This area is dominated by large banks of lockers.

A hyperspatial tunnel leads in the direction of "forthsouth".

* * *

>remove lenses
Faraji takes off the pair of astral lenses.

>e
Agent Faraji is in a sewer tunnel.

>wear lenses
Faraji puts on the pair of astral lenses.

Agent Faraji is in a sewer tunnel. 

A strange sparkly white passage branches off in an impossible direction from here.

Faraji has discovered a hyperspatial tunnel! It leads in the hyperspatial direction of "forth".
For help regarding hyperspace, enter HELP HYPERSPACE.

>l
Agent Faraji is in a sewer tunnel. 

A hyperspatial tunnel leads in the direction of "forth".

>f
Agent Faraji is in the astral tunnel. It is featureless white, or what passes for white here. It leads back and backnorth.

* * *

>bn
Agent Faraji is in the gym basement. This area is dominated by large banks of lockers.

A hyperspatial tunnel leads in the direction of "forthsouth".

>s
(first opening the gymnasium basement door)
It seems to be locked.

>u
Agent Faraji is in the public gymnasium. There is a basketball court and a weight training area. A front desk is next to the front entrance.

On the gym front desk is a membership book.

>w
(first opening the gym door)
It seems to be locked.

* * *

>s
Agent Faraji is in the Book Store Basement.

>u
Agent Faraji is in the Reading Room. 

On the sales counter is Astral Secrets.

>d
Agent Faraji is in the Book Store Basement.

* * *

>n
Agent Faraji is in a sewer tunnel.

>remove lenses
Faraji takes off the pair of astral lenses.

* * *

>e
Faraji can't go that way.

>wear lenses
Faraji puts on the pair of astral lenses.

Agent Faraji is in a sewer tunnel. 

A strange sparkly white passage branches off in an impossible direction from here.

Faraji has discovered a hyperspatial tunnel! It leads in the hyperspatial direction of "forth".
For help regarding hyperspace, enter HELP HYPERSPACE.

* * *

>l
Agent Faraji is in a sewer tunnel. 

A hyperspatial tunnel leads in the direction of "forth".

>undo
sewer tunnel
[Previous turn undone.]

>undo
sewer tunnel
[Previous turn undone.]

>wear lenses
Faraji puts on the pair of astral lenses.

Agent Faraji is in a sewer tunnel. 

A strange sparkly white passage branches off in an impossible direction from here.

Faraji has discovered a hyperspatial tunnel! It leads in the hyperspatial direction of "forth".
For help regarding hyperspace, enter HELP HYPERSPACE.

>e
Faraji can't go that way.

>w
Agent Faraji is in a sewer tunnel.

* * *

>gonear reading room
Agent Faraji is in the Reading Room.

>d
Agent Faraji is in the Book Store Basement.

>x hole
There seems to be nothing special about it.

* * *

>gonear shack
Agent Faraji is in a dirty shack. 

Also here are Hutz and a sledgehammer.

>e
Agent Faraji is walking on Solvay Road by the lake.

>s
Faraji can't go that way.

>se
Agent Faraji is walking on Solvay Road leading out of town.

>e
Agent Faraji is in Enigma Park. It's probably beautiful during the day, but tonight the deep shadows among the trees seem ominous. Faraji is watchful and tense as they explore the park.

The central focus of the park is a large obelisk inscribed with the names of the town's citizens lost in the Great War. The town hall is to the south, and other exits are to the north, west, and east.

>n
Agent Faraji is on the lake shore north of the park.

>se
Agent Faraji is in the workshed. 

Also here is a trap door.

>sw
Faraji can't go that way.

>d
(first opening the trap door)
Agent Faraji is in a hidden cave. 

Also here is a trap door.

>u
Agent Faraji is in the workshed. 

Also here is a trap door.

>close door
Faraji closes the trap door.

>nw
Agent Faraji is on the lake shore north of the park.

>e
Agent Faraji is at the intersection of Lake Street and Ridge Road. The intersection lies at the edge of the lake. Lake Street runs south into town, while Ridge Road heads off into the darkness east of here. A little park along the lake shore is to the west.

There is an abandoned pickup truck at the side of the road.

>enter truck
Faraji can't get into the closed abandoned pickup truck.

>open it
Faraji opens the abandoned pickup truck, revealing nothing.

>enter it
Agent Faraji is at the intersection of Lake Street and Ridge Road. They are in the abandoned pickup truck. There is a glove compartment on the passenger side, closed.

The intersection lies at the edge of the lake. Lake Street runs south into town, while Ridge Road heads off into the darkness east of here. A little park along the lake shore is to the west.

>open glove
Faraji opens the glove compartment, revealing a brass key.

>t
What do you want to t?

I beg your pardon?

>ajk
There's no one here to talk to.

The seeming sound of sibilant speech carries on the breeze.

I beg your pardon?

>take key
Taken.

>w
Faraji would have to get out of the abandoned pickup truck first.

>out
Faraji gets out of the abandoned pickup truck.

Agent Faraji is at the intersection of Lake Street and Ridge Road. The intersection lies at the edge of the lake. Lake Street runs south into town, while Ridge Road heads off into the darkness east of here. A little park along the lake shore is to the west.

There is an abandoned pickup truck at the side of the road.

>w
Agent Faraji is on the lake shore north of the park. 

Faraji turns their head quickly, as if something caught their eye.

>w
Agent Faraji is at the west end of the town's lake shore.

>d
Faraji can't just dig downward.

>s
Agent Faraji is walking on Solvay Road leading out of town.

>w
(first opening the Horton House door)
It seems to be locked.

>s
Agent Faraji is walking on Solvay Road by the fire station. 

Also here is a fire station office door.

>open door
It seems to be locked.

>n
Agent Faraji is walking on Solvay Road leading out of town.

>open door
It seems to be locked.

>x horton house
There seems to be nothing special about it.

>scope
1: a town hall (1146574)
2: Hyperlight (1141742)
3: a ceiling (1141646)
4: a floor (1141614)
5: a wall (1141582)
6: Faraji (1145806)
7: a Horton House door (1147534)
8: a brass key (1147246)
9: the Bureau credit card (1149646)
10: a green smartphone (1149710)

>x hyperlight
There's nothing like that nearby.

>s
Agent Faraji is walking on Solvay Road by the fire station. 

Also here is a fire station office door.

A strange shadow crosses the scene.

>w
(first opening the fire station office door)
It seems to be locked.

>gonear horton family
Agent Faraji is in Horton Family House.

* * *

>l
Agent Faraji is in Horton Family House. 

A strange sparkly white passage branches off in an impossible direction from here.

Faraji has discovered a hyperspatial tunnel! It leads in the hyperspatial direction of "forthsouth".
For help regarding hyperspace, enter HELP HYPERSPACE.

>fs
Agent Faraji is in Hook and Ladder Company #1. 

A hyperspatial tunnel leads in the direction of "backnorth".

Also here are a fire station office door and a ladder.

>bn
Agent Faraji is in Horton Family House. 

A hyperspatial tunnel leads in the direction of "forthsouth".

>gonear fire station 1
Agent Faraji is in Hook and Ladder Company #1. 

A hyperspatial tunnel leads in the direction of "backnorth".

Also here are a fire station office door and a ladder.

* * *

>gonear utility closet
Agent Faraji is in the dark. 

Some light would be nice.

Agent Faraji is in the utility closet.

>l
Agent Faraji is in the utility closet.

>scope
1: a closet door (1153038)
2: Adjacent light (1143662)
3: Hyperlight (1143630)
4: a ceiling (1143534)
5: a floor (1143502)
6: a wall (1143470)
7: Faraji (1147726)
8: the Bureau credit card (1151662)
9: a green smartphone (1151726)

>open door
It seems to be locked.

>showme adjacent light
There seems to be no such object anywhere in the model world.

>knock on door
After a few seconds, someone inserts a key in the lock and opens the door. It's Faraji's colleague Moira Zin. "How'd you get in there, Larch?"

Faraji exits the closet.

Agent Faraji is in Moira's office. 

On Moira's bookshelves is Native Tribes of Upstate New York.

Also here is Moira Zin.

A phone is ringing somewhere else not too far away.

Faraji can tell Moira Zin about the hyperdimensional portal or tell Moira Zin to wait for the report.

(talking to Moira Zin)

>e
Agent Faraji is in the utility closet. 

A phone is ringing faintly somewhere else.

>w
Agent Faraji is in Moira's office. 

On Moira's bookshelves is Native Tribes of Upstate New York.

Also here is Moira Zin.

A phone is ringing somewhere else not too far away.

Faraji can tell Moira Zin about the hyperdimensional portal or tell Moira Zin to wait for the report.

(talking to Moira Zin)

* * *

>i
Faraji is carrying:
  the Bureau credit card
  a green smartphone

>w
Just like in the store this once was, the door chimes as Faraji walks in.

Agent Faraji is in the front office. It's really a small storefront done up to resemble an office. A store sales counter serves as a front desk, behind which are located shelves of office supplies and a row of drawers. There are also a couch and coffee table here creating a makeshift seating area. An old department store clothing rack serves as a coatrack. Photos on the walls picture the Bureau in better days. A stack of used and empty cardboard boxes sits in one corner.

The Bureau's latest office manager, Margaret is bustling around with unrestrained enthusiasm, unpacking boxes and assembling an approximation of a respectable front office, all as if the Bureau isn't going to be shut down before the year is out. She sees Faraji and practically squeals. "Agent Faraji! I'm sorry -- Larch! How are you? I hope you don't mind -- I took the liberty of putting your desk together. I just love hex wrenches, don't you? Also, your new phone is here. I put it in your desk. Now I just need you to give me your old phone so I can deactivate it."

Faraji hands Margaret their old phone. Margaret taps a few keys on her computer and says "There! All settled."

"Oh, good", Faraji says. "Our phone downgrades have arrived from our bureaucratic betters."

A phone is ringing somewhere else not too far away.

Faraji can ask about the phone exchange.

>i
Faraji is carrying:
  the Bureau credit card

A phone is ringing somewhere else not too far away.

Faraji can ask about the phone exchange.

>w
Faraji extricates themself from talking with Margaret.

Agent Faraji is in the hallway. Their office is to the south, Klimp's is to the west, and Moira's is to the north. The front office is east.

A phone is ringing to the south.

>purloin blue phone
[Purloined.]

>answer it
You answer the blue flipphone.
(on the phone with unknown voice)

>hello
Faraji is already talking to the unknown voice.

(on the phone with unknown voice)

>hang up
Faraji says goodbye to unknown voice.
unknown voice says goodbye to Faraji.
They hang up the phone.

>x faraji's desk
I only understood you as far as wanting to examine Faraji's door.

>x faraji's door
There seems to be nothing special about it.

>x desk
There's nothing like that nearby.

>s
Agent Faraji is in their office. They pause and survey the scene. It's not much -- four white walls, grey industrial carpet. Margaret has helpfully assembled Faraji's desk and chair, though how sturdily is an open question. She also took the time to put up some of Agent Faraji's office decor -- their degree in Nonstandard Investigative Techniques, an original pencil drawing of the Pitfall snake by semi-acclaimed Washington DC artist Darius 5200, and a photo of their soccer team. At the very least the wall coverings help compensate for the lack of windows. There's a disconnected landline on the desk. The office door is to the north, and there's a white metal door to the west.

Faraji mutters, "Where's my computer?"

>x faraji's desk
There's nothing like that nearby.

>x desk
The desk is a cheap DIY piece held together with hex screws. It has a single drawer which is closed.

>scope
1: Faraji's door (1095350)
2: Hyperlight (1088214)
3: a ceiling (1088118)
4: a floor (1088086)
5: a wall (1088054)
6: Faraji (1092278)
7: a white metal door (1092662)
8: biffo-light (1094678)
9: their desk (1094710)
10: their office phone (1094742)
11: their desk's drawer (1095030)
12: their chair (1094774)
13: a degree (1094838)
14: a drawing of the Pitfall snake (1094966)
15: a photo of soccer team (1094998)
16: a blue flipphone (1095094)
17: the Bureau credit card (1095158)

* * *

>l
Agent Faraji is at the south end of the strip mall parking lot. From here one can see just how humble BOSH's state has become: the office is to the west, between a pawn shop (to the southwest) and a run-down laundromat (to the northwest) and across from an automatic car wash. To the south is a swampy area separating the lot from the interstate. The parking lot continues north.

Their Hyundai is parked nearby.

>gonear utility closet
[** Programming error: tried to "give" or test "has" or "hasnt" with a non-attribute on the object Adjacent light **]

Agent Faraji is in the dark. 

Some light would be nice.

* * *

>closet
Agent Faraji is in the utility closet.

>knock on door
After a few seconds, someone inserts a key in the lock and opens the door. It's Faraji's colleague Moira Zin. "How'd you get in there, Larch?"

Faraji exits the closet.

Agent Faraji is in Moira's office. 

On Moira's bookshelves is Native Tribes of Upstate New York.

Also here is Moira Zin.

A phone is ringing somewhere else not too far away.

Wearing the astral lenses in fluorescent light is blinding. Faraji quickly removes the glasses.

Faraji can tell Moira Zin about the hyperdimensional portal or tell Moira Zin to wait for the report.

(talking to Moira Zin)

* * *

>e
Agent Faraji is in the utility closet. 

A phone is ringing faintly somewhere else.

>l
Agent Faraji is in the utility closet. 

A phone is ringing faintly somewhere else.

>close door
Faraji closes the closet door.

A phone is ringing faintly somewhere else.

It is now pitch dark in here!

>wear lenses
Faraji puts on the pair of astral lenses.

A phone is ringing faintly somewhere else.

Agent Faraji is in the utility closet.

>open door
Faraji opens the closet door.

A phone is ringing faintly somewhere else.

>w
Agent Faraji is in Moira's office. 

On Moira's bookshelves is Native Tribes of Upstate New York.

Also here is Moira Zin.

A phone is ringing somewhere else not too far away.

Wearing the astral lenses in fluorescent light is blinding. Faraji quickly removes the glasses.

Faraji can tell Moira Zin about the hyperdimensional portal or tell Moira Zin to wait for the report.

(talking to Moira Zin)

>tell her about the portal
Faraji scratches their head. "Um, I was transported there through a hyperdimensional portal. How's your morning been?"

Moira Zin raises an eyebrow. "Well, I suggest you let the Chief know."

A phone is ringing somewhere else not too far away.

(talking to Moira Zin)

>e
Agent Faraji is in the utility closet. 

A phone is ringing faintly somewhere else.

>lights out
A phone is ringing faintly somewhere else.

>l
Agent Faraji is in the utility closet. 

A phone is ringing faintly somewhere else.

>w
Agent Faraji is in Moira's office. 

On Moira's bookshelves is Native Tribes of Upstate New York.

Also here is Moira Zin.

A phone is ringing somewhere else not too far away.

(talking to Moira Zin)

>s
(first opening Moira's door)
Agent Faraji is in the hallway. Their office is to the south, Klimp's is to the west, and Moira's is to the north. The front office is east.

A phone is ringing to the south.

>n
Agent Faraji is in Moira's office. 

On Moira's bookshelves is Native Tribes of Upstate New York.

Also here is Moira Zin.

A phone is ringing somewhere else not too far away.

(talking to Moira Zin)

>e
Agent Faraji is in the utility closet. 

A phone is ringing faintly somewhere else.

* * *

>l
foobar
Agent Faraji is in the utility closet.

>knock on door
After a few seconds, someone inserts a key in the lock and opens the door. It's Faraji's colleague Moira Zin. "How'd you get in there, Larch?"

Faraji exits the closet.

foobar
Agent Faraji is in Moira's office. 

On Moira's bookshelves is Native Tribes of Upstate New York.

Also here is Moira Zin.

A phone is ringing somewhere else not too far away.

Wearing the astral lenses in fluorescent light is blinding. Faraji quickly removes the glasses.

Faraji can tell Moira Zin about the hyperdimensional portal or tell Moira Zin to wait for the report.

(talking to Moira Zin)

>w
Faraji can't go that way.

A phone is ringing somewhere else not too far away.

Faraji can tell Moira Zin about the hyperdimensional portal or tell Moira Zin to wait for the report.

(talking to Moira Zin)

>e
foobar
foobar
Agent Faraji is in the dark. 

Some light would be nice.

A phone is ringing faintly somewhere else.

* * *

>closet
Agent Faraji is in the utility closet.

>remove lenses
Faraji takes off the pair of astral lenses.

It is now pitch dark in here!

>lens
Agent Faraji is in the utility closet.

* * *

>close door
Faraji closes the closet door.

A phone is ringing faintly somewhere else.

It is now pitch dark in here!

>knock on door
There's nothing like that nearby.

>lens
A phone is ringing faintly somewhere else.

Agent Faraji is in the utility closet.

>open door
Faraji opens the closet door.

A phone is ringing faintly somewhere else.

>remove lenses
Faraji takes off the pair of astral lenses.

A phone is ringing faintly somewhere else.

>l
Agent Faraji is in the utility closet. 

A phone is ringing faintly somewhere else.

>w
Agent Faraji is in Moira's office. 

On Moira's bookshelves is Native Tribes of Upstate New York.

Also here is Moira Zin.

A phone is ringing somewhere else not too far away.

Faraji can tell Moira Zin about the hyperdimensional portal or tell Moira Zin to wait for the report.

(talking to Moira Zin)

>lights out
A phone is ringing somewhere else not too far away.

It is now pitch dark in here!

Faraji can tell Moira Zin about the hyperdimensional portal or tell Moira Zin to wait for the report.

(talking to Moira Zin)

>lens
A phone is ringing somewhere else not too far away.

Agent Faraji is in Moira's office. 

On Moira's bookshelves is Native Tribes of Upstate New York.

Also here is Moira Zin.

Faraji can tell Moira Zin about the hyperdimensional portal or tell Moira Zin to wait for the report.

(talking to Moira Zin)

>open moira's door
Faraji opens Moira's door.

A phone is ringing somewhere else not too far away.

Faraji can tell Moira Zin about the hyperdimensional portal or tell Moira Zin to wait for the report.

(talking to Moira Zin)

>remove lenses
Faraji takes off the pair of astral lenses.

A phone is ringing somewhere else not too far away.

Faraji can tell Moira Zin about the hyperdimensional portal or tell Moira Zin to wait for the report.

(talking to Moira Zin)

>close moira's door
Faraji closes Moira's door.

A phone is ringing somewhere else not too far away.

It is now pitch dark in here!

Faraji can tell Moira Zin about the hyperdimensional portal or tell Moira Zin to wait for the report.

(talking to Moira Zin)

>open door
There's nothing like that nearby.

(talking to Moira Zin)

* * *

>open door
Which do you mean, the closet door or Moira's door?

(talking to Moira Zin)

>moira's
Faraji opens Moira's door.

A phone is ringing somewhere else not too far away.

Faraji can tell Moira Zin about the hyperdimensional portal or tell Moira Zin to wait for the report.

(talking to Moira Zin)

>e
Agent Faraji is in the utility closet. 

A phone is ringing faintly somewhere else.

>remove lenses
Faraji takes off the pair of astral lenses.

A phone is ringing faintly somewhere else.

It is now pitch dark in here!

>w
Agent Faraji is in Moira's office. 

On Moira's bookshelves is Native Tribes of Upstate New York.

Also here is Moira Zin.

A phone is ringing somewhere else not too far away.

Faraji can tell Moira Zin about the hyperdimensional portal or tell Moira Zin to wait for the report.

(talking to Moira Zin)

>e
Agent Faraji is in the dark. 

Some light would be nice.

A phone is ringing faintly somewhere else.

* * *

>enigma
Agent Faraji is in the Enigma Lake town hall. The building has been cleared of furniture and other items ahead of the imminent flooding. A permanent fixture, the information desk sits near the front entrance (to the south). Taped to it is what looks to be a work schedule. There is also a back entrance onto the park to the north.

>wear lenses
Faraji's already wearing that!

* * *

>i
Faraji is carrying:
  a pair of astral lenses (being worn)
  the Bureau credit card
  a green smartphone

>w
Just like in the store this once was, the door chimes as Faraji walks in.

Agent Faraji is in the front office. It's really a small storefront done up to resemble an office. A store sales counter serves as a front desk, behind which are located shelves of office supplies and a row of drawers. There are also a couch and coffee table here creating a makeshift seating area. An old department store clothing rack serves as a coatrack. Photos on the walls picture the Bureau in better days. A stack of used and empty cardboard boxes sits in one corner.

The Bureau's latest office manager, Margaret is bustling around with unrestrained enthusiasm, unpacking boxes and assembling an approximation of a respectable front office, all as if the Bureau isn't going to be shut down before the year is out. She sees Faraji and practically squeals. "Agent Faraji! I'm sorry -- Larch! How are you? I hope you don't mind -- I took the liberty of putting your desk together. I just love hex wrenches, don't you? Also, your new phone is here. I put it in your desk. Now I just need you to give me your old phone so I can deactivate it."

Faraji hands Margaret their old phone. Margaret taps a few keys on her computer and says "There! All settled."

"Oh, good", Faraji says. "Our phone downgrades have arrived from our bureaucratic betters."

A phone is ringing not too far away.

Wearing the astral lenses in fluorescent light is blinding. Faraji quickly removes the glasses.

Faraji can ask about the phone exchange.

>ask about phone
Faraji asks, "Tell me what's going on with the phones again?"

Margaret looks apologetic. "I'm sorry, I thought everyone knew. Budget cuts. They're trading in all our smart phones for cheaper models."

A phone is ringing not too far away.

>i
Faraji is carrying:
  a pair of astral lenses
  the Bureau credit card

A phone is ringing not too far away.

>e
Faraji steps out of the office into the parking lot.

Agent Faraji is at the south end of the strip mall parking lot. From here one can see just how humble BOSH's state has become: the office is to the west, between a pawn shop (to the southwest) and a run-down laundromat (to the northwest) and across from an automatic car wash. To the south is a swampy area separating the lot from the interstate. The parking lot continues north.

Their Hyundai is parked nearby.

>n
Faraji trudges to the other end of the parking lot. It's much like where they left.

Agent Faraji is at the north end of the strip mall parking lot. This end is no more auspicious than the other. A convenience store lies to the east. To the west is a military recruitment center. North of here the parking lot exits onto a busy road. There is a rusty sign by the road naming the shopping center: Park Place. South is BOSH headquarters, among other things.

>e
Faraji is greeted by a blast of music as they enter the store.

Agent Faraji is in the Li'l Nectarine Convenience Store. Li'l Nectarine offers great service and low prices, or so they say. This one's cluttered aisles and sparse shelves could make one wonder if that's true. Behind the counter is the typical array of cigarettes and lottery tickets. Under the counter is a glass case containing various useful items.

The clerk, a scruffy man in his mid-twenties, is leaning against the counter, looking bored.

>x case
In the glass case are a flashlight, a red screwdriver, a laptop computer and some wireless earbuds.

>how much is flashlight
I'm not sure what you're trying to say. I might just not recognize the words you're using.

>ask man about flashlight
Yeah, that's mine.

That doesn't seem to be a topic of conversation at the moment.

>ask clerk about flashlight
Yeah, that's mine.

That doesn't seem to be a topic of conversation at the moment.

* * *

>n
Faraji trudges to the other end of the parking lot. It's much like where they left.

Agent Faraji is at the north end of the strip mall parking lot. This end is no more auspicious than the other. A convenience store lies to the east. To the west is a military recruitment center. North of here the parking lot exits onto a busy road. There is a rusty sign by the road naming the shopping center: Park Place. South is BOSH headquarters, among other things.

* * *

>e
Faraji is greeted by a blast of music as they enter the store.

Agent Faraji is in the Li'l Nectarine Convenience Store. Li'l Nectarine offers great service and low prices, or so they say. This one's cluttered aisles and sparse shelves could make one wonder if that's true. Behind the counter is the typical array of cigarettes and lottery tickets. Under the counter is a glass case containing various useful items.

The clerk, a scruffy man in his mid-twenties, is leaning against the counter, looking bored.

>ask about case
Faraji says, "Tell me about the glass case."

"You want something, just ask."

>e
Faraji can't go that way.

>w
Faraji exits the store into the relative quiet of the nearby traffic.

Agent Faraji is at the north end of the strip mall parking lot. This end is no more auspicious than the other. A convenience store lies to the east. To the west is a military recruitment center. North of here the parking lot exits onto a busy road. There is a rusty sign by the road naming the shopping center: Park Place. South is BOSH headquarters, among other things.

>s
Faraji walks back to the south end of the parking lot.

Agent Faraji is at the south end of the strip mall parking lot. From here one can see just how humble BOSH's state has become: the office is to the west, between a pawn shop (to the southwest) and a run-down laundromat (to the northwest) and across from an automatic car wash. To the south is a swampy area separating the lot from the interstate. The parking lot continues north.

Their Hyundai is parked nearby.

>w
Just like in the store this once was, the door chimes as Faraji walks in.

Agent Faraji is in the front office. It's really a small storefront done up to resemble an office. A store sales counter serves as a front desk, behind which are located shelves of office supplies and a row of drawers. There are also a couch and coffee table here creating a makeshift seating area. An old department store clothing rack serves as a coatrack. Photos on the walls picture the Bureau in better days. A stack of used and empty cardboard boxes sits in one corner.

The Bureau's latest office manager, Margaret is bustling around with unrestrained enthusiasm, unpacking boxes and assembling an approximation of a respectable front office, all as if the Bureau isn't going to be shut down before the year is out. She sees Faraji and practically squeals. "Agent Faraji! I'm sorry -- Larch! How are you? I hope you don't mind -- I took the liberty of putting your desk together. I just love hex wrenches, don't you? Also, your new phone is here. I put it in your desk. Now I just need you to give me your old phone so I can deactivate it."

Faraji hands Margaret their old phone. Margaret taps a few keys on her computer and says "There! All settled."

"Oh, good", Faraji says. "Our phone downgrades have arrived from our bureaucratic betters."

A phone is ringing not too far away.

Faraji can ask about the phone exchange.

>ask about the desk
That doesn't seem to be a topic of conversation at the moment.

A phone is ringing not too far away.

Faraji can ask about the phone exchange.

>ask about the coatrack
Faraji says, "Tell me about the coatrack, Margaret."

She grins. "Good thinking, right?"

A phone is ringing not too far away.

Faraji can ask about the phone exchange.

* * *

>e
Faraji is greeted by a blast of music as they enter the store.

Agent Faraji is in the Li'l Nectarine Convenience Store. Li'l Nectarine offers great service and low prices, or so they say. This one's cluttered aisles and sparse shelves could make one wonder if that's true. Behind the counter is the typical array of cigarettes and lottery tickets. Under the counter is a glass case containing various useful items.

The clerk, a scruffy man in his mid-twenties, is leaning against the counter, looking bored.

>ask clerk about case
Faraji says, "Tell me about the glass case."

"You want something inside, just ask."

>x case
In the glass case are a flashlight, a red screwdriver, a laptop computer and some wireless earbuds.

>ask about flashlight
"I'll sell it for $5."

>ask about red
"I'll sell it for $5."

>ask about computer
"I'll sell it for $1200."

>ask about earbuds
"I'll sell them for $85."

>pronouns
At the moment, "it" means the laptop computer, "him" means the store clerk, "her" is unset, "them" means the wireless earbuds and "me" means Larch Faraji.

>ask about me
That doesn't seem to be a topic of conversation at the moment.

>ask about clerk
That doesn't seem to be a topic of conversation at the moment.

>ask about screwdriver
"I'll sell it for $5."

* * *

>e
Faraji is greeted by a blast of music as they enter the store.

Agent Faraji is in the Li'l Nectarine Convenience Store. Li'l Nectarine offers great service and low prices, or so they say. This one's cluttered aisles and sparse shelves could make one wonder if that's true. Behind the counter is the typical array of cigarettes and lottery tickets. Under the counter is a glass case containing various useful items.

The clerk, a scruffy man in his mid-twenties, is leaning against the counter, looking bored.

>x clerk
The clerk looks as if he'd rather be anywhere else. He's wearing jeans and a white t-shirt with something inscrutable scrawled on it. His hair sticks up every which way.

* * *

>ne
A fence prevents Faraji from leaving the property.

>w
Just like in the store this once was, the door chimes as Faraji walks in.

Agent Faraji is in the front office. It's really a small storefront done up to resemble an office. A store sales counter serves as a front desk, behind which are located shelves of office supplies and a row of drawers. There are also a couch and coffee table here creating a makeshift seating area. An old department store clothing rack serves as a coatrack. Photos on the walls picture the Bureau in better days. A stack of used and empty cardboard boxes sits in one corner.

The Bureau's latest office manager, Margaret is bustling around with unrestrained enthusiasm, unpacking boxes and assembling an approximation of a respectable front office, all as if the Bureau isn't going to be shut down before the year is out. She sees Faraji and practically squeals. "Agent Faraji! I'm sorry -- Larch! How are you? I hope you don't mind -- I took the liberty of putting your desk together. I just love hex wrenches, don't you? Also, your new phone is here. I put it in your desk. Now I just need you to give me your old phone so I can deactivate it."

Faraji hands Margaret their old phone. Margaret taps a few keys on her computer and says "There! All settled."

"Oh, good", Faraji says. "Our phone downgrades have arrived from our bureaucratic betters."

A phone is ringing not too far away.

Faraji can ask about-the-phone-exchange.

* * *

>purloin red key
[Purloined.]

>gonear basement
Which do you mean, the laundromat basement, the back basement or the gym basement?

>gym
Agent Faraji is in the gym basement. This area is dominated by large banks of lockers.

>open 1
Faraji is hardly going to try opening every locker. There must be a better way to go about this.

>i
Faraji is carrying:
  a red key
  the Bureau credit card
  a green smartphone

>open 45
Faraji is hardly going to try opening every locker. There must be a better way to go about this.

>open 111
Faraji is hardly going to try opening every locker. There must be a better way to go about this.

>open -2
Faraji is hardly going to try opening every locker. There must be a better way to go about this.

* * *

>purloin red key
[Purloined.]

>gonear gymnasium
Agent Faraji is in the public gymnasium. There is a basketball court and a weight training area. A front desk is next to the front entrance.

On the gym front desk is a record book.

>read book
There seems to be nothing special about it.

>lookup book
I'm not sure what you're trying to say. I might just not recognize the words you're using.

>look up william thompson
I only understood you as far as wanting to look up.

>take book
That can't be picked up.

>x book
There seems to be nothing special about it.

>look up asdfasdf in book
Faraji discovers nothing of interest in the record book.

* * *

>q
Are you sure you want to quit?

* * *

>what thumb drive
Faraji looks quizzical. "What thumb drive?"

"Huh. Thought you would have found it by now. I'm almost certain it's in your Swamp Park office. Go find it and bring it here." Doris busies himself at his desk, pointedly ignoring you.

Faraji can ask who he is, ask where we are or ask how to get home.

>e
Agent Faraji is in the field office hallway. Hallway

>purloin drive
Which do you mean, they don't have it, what thumb drive, show him the thumb drive, hand over the thumb drive, the thumb drive or finding the drive?

>thumb
Which do you mean, they don't have it, what thumb drive, show him the thumb drive, hand over the thumb drive or the thumb drive?

>all
[Purloined.]
[Purloined.]
[Purloined.]
[Purloined.]
[Purloined.]

>i
Faraji is carrying:
  a thumb drive
  hand over the thumb drive
  show him the thumb drive
  what thumb drive
  they don't have it
  a mystic compass
  a pair of astral lenses (being worn)
  the Bureau credit card

>w
Agent Faraji is in the field office chief's office. Doris's office

Doris is sitting cross-legged in a chair, tapping his foot lazily on the desk.

Faraji can ask who he is, ask where we are, ask how to get home or show him the thumb drive.

>show him the thumb drive
Which do you mean, the thumb drive, hand over the thumb drive, show him the thumb drive, what thumb drive or they don't have it?

>show him
What do you want to show Doris?

>show him drive
Which do you mean, the thumb drive, hand over the thumb drive, show him the thumb drive, what thumb drive or they don't have it?

* * *

>ask about his name
Faraji says, "Tell me about your name."

"None of your business", Doris replies.

Faraji can ask where we are, ask how to get home or show him the thumb drive.

>ask where  we are
Faraji looks around and asks, "Where are we? What is this place?"

Doris answers, "You're in the hyperspatial field office of the Bureau of Strange Happenings. But I guess that doesn't exactly clear things up for you. Practically, your office is a branch of ours, but since you have the official recognition of the US government -- for now -- you get the glory. Besides, due to the nature of our work, we prefer to remain underground, so to speak. How's Klimp, by the way? Ah, we had some good times. But you know what they say -- what happens in Pompeii, stays in Pompeii.

Faraji can ask how to get home, tell Doris Klimp is fine or show him the thumb drive.

>ask how to get home
Faraji asks, "Just how can I get home from here?"

"Go ask Maggie; she can help you."

Faraji can tell Doris Klimp is fine or show him the thumb drive.

>tell doris klimp is fine
Faraji says, "He's just fine"

"Great! Be sure to say hi for me."

Faraji can show him the thumb drive.

>show him the drive
Faraji answers, "Yes, I have it."

"Fantastic! Hand it here."

Faraji can hand over the thumb drive.

>hand it over
Faraji gives the thumb drive to Doris.

"Great, great." He peruses the drive. "We lost one of our New York agents to a slingshot effect that threw him far back in time. We're always monitoring for artifacts that are out of place or anachronistic to lead us to lost agents.

He continues, "The scratch marks here say, 'They found me out and sent me back. 14th century. Enigma Lake. Savra is going to move on the Dragon.'"

Faraji can ask about Savra, ask about the Dragon or ask about time travel.

>record off
Not recording a test.

Faraji can ask about Savra, ask about the Dragon or ask about time travel.

* * *

>gonear porsche
Agent Faraji is at the south end of the strip mall parking lot. From here one can see just how humble BOSH's state has become: the office is to the west, between a pawn shop (to the southwest) and a run-down laundromat (to the northwest) and across from an automatic car wash. To the south is a swampy area separating the lot from the interstate. The parking lot continues north.

Klimp's Porsche takes up two spots.

Their Hyundai is parked nearby.

>push porsche
Faraji could probably push the car if they put it in neutral and released the parking brake, but why would they?

>push hundai
There's nothing like that nearby.

>move hyundai
Faraji could probably push the car if they put it in neutral and released the parking brake, but why would they?

>take it
That can't be picked up.

>take porche
There's nothing like that nearby.

>take porsche
That can't be picked up.

>gonear town hall
Agent Faraji is in the Enigma Lake town hall.

>press button
The world turns inside out, and suddenly you're somewhere else.

Agent Faraji is in the field office chief's office. Doris's office

Doris is sitting cross-legged in a chair, tapping his foot lazily on the desk.

* * *

>i
Faraji is carrying:
  a mystic compass
  a pair of astral lenses (being worn)
  the Bureau credit card

Faraji can tell Doris they don't have it, ask about Savra, ask about the Dragon or ask about time travel.

>i don't have it
I only understood you as far as wanting to take inventory.

>tell doris i don't hvae it
That doesn't seem to be a topic of conversation at the moment.

Faraji can tell Doris they don't have it, ask about Savra, ask about the Dragon or ask about time travel.

>tell doris i don't have it
Faraji shakes their head. "Sorry, no."

"Well, you'll just have to go back and get it, won't you? We can't be fooling around when the fate of the timeline is at stake!" Doris says.

Faraji can ask about Savra, ask about the Dragon or ask about time travel.

* * *

>i
Faraji is carrying:
  a mystic compass
  a pair of astral lenses (being worn)
  the Bureau credit card

Faraji can tell Doris they don't have it, ask about Savra, ask about the Dragon or ask about time travel.

>undo
field office chief's office
[Previous turn undone.]

>undo
field office chief's office
[Previous turn undone.]

>i
Faraji is carrying:
  a mystic compass
  a pair of astral lenses (being worn)
  a thumb drive
  the Bureau credit card

Faraji can hand over the thumb drive.

>rules
Rules tracing now switched on. Type "rules off" to switch it off again, or "rules all" to include even rules which do not apply.

[Rule "clear LPR rule" applies.]
[Rule "reset skip sounds rule" applies.]

>rules off
[Rule "redirect to GEP line input rule" applies.]
[Rule "ordinary checking for content rule" applies.]
[Rule "After reading a command" applies.]
[Rule "declare everything initially unmentioned rule" applies.]
Rules tracing now switched off. Type "rules" to switch it on again.

>actions
Actions listing on.

>hand it over
[discussing hand over the thumb drive]
Faraji gives the thumb drive to Doris.

"Great, great." He peruses the drive. "We lost one of our New York agents to a slingshot effect that threw him far back in time. We're always monitoring for artifacts that are out of place or anachronistic to lead us to lost agents.

He continues, "The scratch marks here say, 'They found me out and sent me back. 14th century. Enigma Lake. Savra is going to move on the Dragon.'"

[(1) giving the thumb drive to Doris - silently]
[(1) giving the thumb drive to Doris - silently - succeeded]

[discussing hand over the thumb drive - succeeded]

Faraji can ask about Savra, ask about the Dragon or ask about time travel.

>i
[taking inventory]
Faraji is carrying:
  a mystic compass
  a pair of astral lenses (being worn)
  a thumb drive
  the Bureau credit card

[taking inventory - succeeded]

Faraji can ask about Savra, ask about the Dragon or ask about time travel.

* * *

>record win
Recording.

Faraji can ask about Savra, ask about the Dragon or ask about time travel.

>ask about his name
Faraji says, "Tell me about your name."

"None of your business", Doris replies.

Faraji can ask where we are, ask how to get home or show him the thumb drive.

>where are we
Faraji looks around and asks, "Where are we? What is this place?"

Doris answers, "You're in the hyperspatial field office of the Bureau of Strange Happenings. But I guess that doesn't exactly clear things up for you. Practically, your office is a branch of ours, but since you have the official recognition of the US government -- for now -- you get the glory. Besides, due to the nature of our work, we prefer to remain underground, so to speak. How's Klimp, by the way? Ah, we had some good times. But you know what they say -- what happens in Pompeii, stays in Pompeii.

Faraji can ask how to get home, tell Doris Klimp is fine or show him the thumb drive.

>klimp is fine
Faraji says, "He's just fine"

"Great! Be sure to say hi for me."

Faraji can ask how to get home or show him the thumb drive.

>ask how to get home
Faraji asks, "Just how can I get home from here?"

"Go ask Maggie; she can help you."

Faraji can show him the thumb drive.

>show him the thumb drive
Faraji answers, "Yes, I have it."

"Fantastic! Hand it here."

Faraji can hand over the thumb drive.

>hand it over
Faraji gives the thumb drive to Doris.

"Great, great." He peruses the drive. "We lost one of our New York agents to a slingshot effect that threw him far back in time. We're always monitoring for artifacts that are out of place or anachronistic to lead us to lost agents.

He continues, "The scratch marks here say, 'They found me out and sent me back. 14th century. Enigma Lake. Savra is going to move on the Dragon.'"

Faraji can ask about Savra, ask about the Dragon or ask about time travel.

>ask savra
"Senator Savra? What does he have to with anything?" Faraji asks.

Doris says, "Well you've noticed he's not very friendly to the Bureau? Let's leave it at that for now. We need to talk about the mission."

Faraji can ask about the mission, ask about the Dragon or ask about time travel.

>ask about mission
"Fine," Faraji says. "What's the mission?"

Doris leans back in his chair. "I believe we still have a chance to retrieve our lost agent -- the one that left the thumb drive. He says he was at Enigma Lake, not far from where you found the drive. Now it makes sense that Daniels -- the agent -- would head for some kind of landmark so we could find him, and indeed there is a prominent intersection of leylines in the middle of the lake. Before you say it, yes it's a problem, if that intersection had always been underwater. But Enigma Lake is an artificial reservoir. The town of Enigma Lake was flooded when the reservoir was created, and that's where the intersection is!" Doris concludes with a look of satisfaction.

"So..." Faraji says.

"So. I'm sending you back to 1954, right before the flooding of Enigma Lake, and you'll find whatever Daniels left for us to find. Maybe we can stage a rescue. Why 1954? I'd rather not risk a longer temporal jaunt before we know what we're dealing with."

Faraji can ask about the Dragon, ask about time travel or ask how will i find him.

>how will i find him
"How am I going to find him? Didn't he leave that message in the fourteenth century?"

Doris looks exasperated. "Well I don't know -- Improvise, use the power of the leylines, look around for anything that looks like it might be a time portal. Something like that. Let's see if the DC office can impress me. Let me know when you're ready to go."

Faraji can ask about the Dragon, ask about time travel or tell Doris they're ready to go.

>ask about the dragon
Faraji says, "Who is this 'Dragon'?"

Doris brings his finger to his lips. "Classified. Need to know only. But we should be talking about the mission instead."

Faraji can ask about time travel or tell Doris they're ready to go.

>ask about time travel
Disbelievingly, Faraji asks, "Time travel? For real?"

"Yes, yes," Doris responds. "Don't get too worked up over it. It gets old fast. But now we need to talk about the mission."

Faraji can tell Doris they're ready to go.

>ready to go
Squaring their shoulders, Faraji says, "Ready to go."

Doris grins. "Great! First, you'll need this." He hands you a small device. "In case you need to come back for any reason, press this button and you'll come back here. Do not abuse this for trivial matters! Time travel consumes valuable resources. Now go. Out of my office and to the forth you'll find the portal room. It's all ready to send you where you need to go."

>i
Faraji is carrying:
  a recall device
  a mystic compass
  a pair of astral lenses (being worn)
  a thumb drive
  the Bureau credit card

>x device
A small, flat, black device with a small black button on it.

>press button
There's nothing like that nearby.

>use device
I'm not sure what you're trying to say. I might just not recognize the words you're using.

>press button on device
There's nothing like that nearby.

>record off
test text:
test win with "ask about his name/where are we/klimp is fine/ask how to get home/show him the thumb drive/hand it over/ask savra/ask about mission/how will i find him/ask about the dragon/ask about time travel/ready to go/i/x device".

Recording stopped.

>record win
Recording.

>e
Agent Faraji is in the field office hallway. Hallway

>f
Agent Faraji is in Portal Room 1. 

A hyperspatial tunnel leads in the direction of "back".

Also here is a portal to the past.

>enter portal
Faraji enters the field of light, and suddenly is somewhere else.

Agent Faraji is in the Enigma Lake town hall.

>record off
test text:
test win with "ask about his name/where are we/klimp is fine/ask how to get home/show him the thumb drive/hand it over/ask savra/ask about mission/how will i find him/ask about the dragon/ask about time travel/ready to go/i/x device/e/f/enter portal".

Recording stopped.

* * *

>record win
Recording.

Faraji can ask about Savra, ask about the Dragon or ask about time travel.

>ask about savra
"Senator Savra? What does he have to with anything?" Faraji asks.

Doris says, "Well you've noticed he's not very friendly to the Bureau? Let's leave it at that for now. We need to talk about the mission."

Faraji can ask about the mission, ask about the Dragon or ask about time travel.

>ask about the dragon
Faraji says, "Who is this 'Dragon'?"

Doris brings his finger to his lips. "Classified. Need to know only. But we should be talking about the mission instead."

Faraji can ask about the mission or ask about time travel.

>time travel
Disbelievingly, Faraji asks, "Time travel? For real?"

"Yes, yes," Doris responds. "Don't get too worked up over it. It gets old fast. But now we need to talk about the mission."

Faraji can ask about the mission.

>ask about the mission
"Fine," Faraji says. "What's the mission?"

Doris leans back in his chair. "I believe we still have a chance to retrieve our lost agent -- the one that left the thumb drive. He says he was at Enigma Lake, not far from where you found the drive. Now it makes sense that Daniels -- the agent -- would head for some kind of landmark so we could find him, and indeed there is a prominent intersection of leylines in the middle of the lake. Before you say it, yes it's a problem, if that intersection had always been underwater. But Enigma Lake is an artificial reservoir. The town of Enigma Lake was flooded when the reservoir was created, and that's where the intersection is!" Doris concludes with a look of satisfaction.

"So..." Faraji says.

"So. I'm sending you back to 1954, right before the flooding of Enigma Lake, and you'll find whatever Daniels left for us to find. Maybe we can stage a rescue. Why 1954? I'd rather not risk a longer temporal jaunt before we know what we're dealing with."

Faraji can ask how will i find him.

>how will i find him
"How am I going to find him? Didn't he leave that message in the fourteenth century?"

Doris looks exasperated. "Well I don't know -- Improvise, use the power of the leylines, look around for anything that looks like it might be a time portal. Something like that. Let's see if the DC office can impress me. Let me know when you're ready to go."

Faraji can tell Doris they're ready to go.

>e
Agent Faraji is in the field office hallway. Hallway

>w
Agent Faraji is in the field office chief's office. Doris's office

Doris is sitting cross-legged in a chair, tapping his foot lazily on the desk.

Faraji can tell Doris they're ready to go.

>ready to go
Squaring their shoulders, Faraji says, "Ready to go."

Doris grins. "Great! First, you'll need this." He hands you a small device. "In case you need to come back for any reason, press this button and you'll come back here. Do not abuse this for trivial matters! Time travel consumes valuable resources. Now go. Out of my office and to the forth you'll find the portal room. It's all ready to send you where you need to go."

>i
Faraji is carrying:
  a recall device
  a mystic compass
  a pair of astral lenses (being worn)
  the Bureau credit card

>x device
A small, flat, black device with a small black button on it.

>w
Faraji can't go that way.

* * *

>enter portal
Faraji enters the field of light, and suddenly is somewhere else.

Agent Faraji is in the Enigma Lake town hall.

>record off
test text:
test win with "ask about savra/ask about the dragon/time travel/ask about the mission/how will i find him/e/w/ready to go/i/x device/w/e/f/enter portal".

Recording stopped.

* * *

>record win
Recording.

Faraji can ask about Savra, ask about the Dragon or ask about time travel.

>show him the thumb drive
Faraji answers, "Yes, I have it."

"Fantastic! Hand it here."

Faraji can ask who he is, ask where we are, ask how to get home or hand over the thumb drive.

>hand it over
Faraji gives the thumb drive to Doris.

"Great, great." He peruses the drive. "We lost one of our New York agents to a slingshot effect that threw him far back in time. We're always monitoring for artifacts that are out of place or anachronistic to lead us to lost agents.

He continues, "The scratch marks here say, 'They found me out and sent me back. 14th century. Enigma Lake. Savra is going to move on the Dragon.'"

Faraji can ask who he is, ask where we are, ask how to get home, ask about Savra, ask about the Dragon or ask about time travel.

>ask who he is
Faraji asks "Who are you?"

He looks taken aback for a moment, then recovers his composure. "Ah yes, introductions. I'm Doris, chief of the hyperspatial field office of the Bureau."

Faraji can ask where we are, ask how to get home, ask about Savra, ask about the Dragon or ask about time travel.

>record stop
Already recording a test.

Faraji can ask where we are, ask how to get home, ask about Savra, ask about the Dragon or ask about time travel.

>record off
test text:
test win with "show him the thumb drive/hand it over/ask who he is".

Recording stopped.

Faraji can ask where we are, ask how to get home, ask about Savra, ask about the Dragon or ask about time travel.

* * *

>w
Just like in the store this once was, the door chimes as Faraji walks in.

Agent Faraji is in the front office. It's really a small storefront done up to resemble an office. A store sales counter serves as a front desk, behind which are located shelves of office supplies and a row of drawers. There are also a couch and coffee table here creating a makeshift seating area. An old department store clothing rack serves as a coatrack. Photos on the walls picture the Bureau in better days. A stack of used and empty cardboard boxes sits in one corner.

The Bureau's latest office manager, Margaret is bustling around with unrestrained enthusiasm, unpacking boxes and assembling an approximation of a respectable front office, all as if the Bureau isn't going to be shut down before the year is out. She sees Faraji and practically squeals. "Agent Faraji! I'm sorry -- Larch! How are you? I hope you don't mind -- I took the liberty of putting your desk together. I just love hex wrenches, don't you? Also, your new phone is here. I put it in your desk. Now I just need you to give me your old phone so I can deactivate it."

Faraji hands Margaret their old phone. Margaret taps a few keys on her computer and says "There! All settled."

"Oh, good", Faraji says. "Our phone downgrades have arrived from our bureaucratic betters."

A phone is ringing somewhere else not too far away.

Faraji can ask about the phone exchange.

(talking to Margaret)

>ask about coatrack
Faraji says, "Tell me about the coatrack, Margaret."

She grins. "Good thinking, right?"

A phone is ringing not too far away.

>ask about wall
That doesn't seem to be a topic of conversation at the moment.

A phone is ringing not too far away.

>scope
1: Hyperlight (1090326)
2: a ceiling (1090230)
3: a floor (1090198)
4: a wall (1090166)
5: Faraji (1094294)
6: Margaret (1092182)
7: a coffee table (1092214)
8: a couch (1092246)
9: a seating area (1092278)
10: a coatrack (1092310)
11: a front desk (1092342)
12: some shelves of office supplies (1092374)
13: some cardboard boxes (1092406)
14: the Bureau credit card (1096886)

>x shelves
Pens, paper, nothing Faraji's really concerned with now.

A phone is ringing not too far away.

>x pens
There's nothing like that nearby.

* * *

>ask about herself
"How are you, Margaret?"

"I'm doing great, thanks!"

A phone is ringing somewhere else not too far away.

Faraji can ask about the phone exchange.

* * *

>ask about klimp
Faraji says, "Margaret, Have you seen Klimp this morning?"

She shakes her head. "He hasn't been in yet."

A phone is ringing somewhere else not too far away.

Faraji can ask about the phone exchange.

>ask about bureau
(the Bureau credit card)
That doesn't seem to be a topic of conversation at the moment.

A phone is ringing somewhere else not too far away.

Faraji can ask about the phone exchange.

>ask about BOSH
(the Bureau of Strange Happenings)
That doesn't seem to be a topic of conversation at the moment.

A phone is ringing somewhere else not too far away.

Faraji can ask about the phone exchange.

>ask aboiut moira
I'm not sure what you're trying to say. I might just not recognize the words you're using.

>ask about moira
Faraji says, "Has Moira come in yet?"

Margaret barely looks up from her work. "Nope."

A phone is ringing somewhere else not too far away.

Faraji can ask about the phone exchange.

>ask about margaret
(Margaret)
That doesn't seem to be a topic of conversation at the moment.

A phone is ringing somewhere else not too far away.

Faraji can ask about the phone exchange.

>ask about herself
That doesn't seem to be a topic of conversation at the moment.

A phone is ringing somewhere else not too far away.

Faraji can ask about the phone exchange.

>ask about couch
That doesn't seem to be a topic of conversation at the moment.

A phone is ringing somewhere else not too far away.

Faraji can ask about the phone exchange.

>ask about table
Faraji says, "Tell me about the coffee table, Margaret."

"It's not much, but what can you expect for $8?"

A phone is ringing somewhere else not too far away.

Faraji can ask about the phone exchange.

>ask about rack
Faraji says, "Tell me about the coatrack, Margaret."

She grins. "An old clothing rack. Good thinking, right?"

A phone is ringing somewhere else not too far away.

Faraji can ask about the phone exchange.

* * *

>ask about phone
Faraji asks, "Tell me what's going on with the phones again?"

Margaret looks apologetic. "I'm sorry, I thought everyone knew. Budget cuts. They're trading in all our smart phones for cheaper models."

A phone is ringing somewhere else not too far away.

>x photo
There's nothing like that nearby.

>x photos
The photo of Ezra Gaunt and Petula Goldberg smiling together is particularly poignant, as they were just let go last month.

A phone is ringing somewhere else not too far away.

* * *

>ask about the phone
Faraji asks, "What's going on with the phones, Margaret?"

Margaret looks apologetic. "I'm sorry, I thought everyone knew. Budget cuts. They're trading in all our smart phones for cheaper models."

A phone is ringing not too far away.

>x ceiling
Faraji sees nothing special about the ceiling.

A phone is ringing not too far away.

>x floor
Faraji sees nothing special about the floor.

A phone is ringing not too far away.

>look up
Faraji sees nothing special about the ceiling.

A phone is ringing not too far away.

>look north
Faraji sees nothing unexpected in that direction.

A phone is ringing not too far away.

>x wall
Faraji sees nothing special about the walls.

A phone is ringing not too far away.

* * *

>ask about the phone
Faraji asks, "What's going on with the phones, Margaret?"

Margaret looks apologetic. "I'm sorry, I thought everyone knew. Budget cuts. They're trading in all our smart phones for cheaper models."

A phone is ringing not too far away.

>x phone
There's nothing like that nearby.

>purloin blue phone
[Purloined.]

>z
Faraji stands around and waits.

The blue flipphone you are carrying is ringing.

>drop it
Dropped.

The blue flipphone is ringing.

>w
Faraji extricates themself from talking with Margaret.

Agent Faraji is in the hallway. Their office is to the south, Klimp's is to the west, and Moira's is to the north. The front office is east.

A phone is ringing to the east, in the front office.

>s
Agent Faraji is in their office. They pause and survey the scene. It's not much -- four white walls, grey industrial carpet. Margaret has helpfully assembled Faraji's desk and chair, though how sturdily is an open question. She also took the time to put up some of Agent Faraji's office decor -- their degree in Nonstandard Investigative Techniques, an original pencil drawing of the Pitfall snake by semi-acclaimed Washington DC artist Darius 5200, and a photo of their softball team. At the very least the wall coverings help compensate for the lack of windows. There's a disconnected landline on the desk. The office door is to the north, and there's a white metal door to the west.

Faraji mutters, "Where's my computer?"

A phone is ringing not too far away.

>n
Agent Faraji is in the hallway. Their office is to the south, Klimp's is to the west, and Moira's is to the north. The front office is east.

A phone is ringing to the east, in the front office.

>e
Agent Faraji is in the front office. It's really a small storefront done up to resemble an office. A store sales counter serves as a front desk, behind which are located shelves of office supplies and a row of drawers. There are also a couch and coffee table here creating a makeshift seating area. An old department store clothing rack serves as a coatrack. Photos on the walls picture the Bureau in better days. A stack of used and empty cardboard boxes sits in one corner.

The Bureau's latest office manager, Margaret is bustling around with unrestrained enthusiasm.

Also here is a blue flipphone.

The blue flipphone is ringing.

Faraji can ask about the status of the computer.

>x phone
Faraji doesn't recognize the number on the caller ID.

The blue flipphone is ringing.

Faraji can ask about the status of the computer.

>out
Faraji steps out of the office into the parking lot.

Agent Faraji is at the south end of the strip mall parking lot. From here one can see just how humble BOSH's state has become: the office is to the west, between a pawn shop (to the southwest) and a run-down laundromat (to the northwest) and across from an automatic car wash. To the south is a swampy area separating the lot from the interstate. The parking lot continues north.

Their Hyundai is parked nearby.

A phone is ringing inside the front office.

>in
Agent Faraji is in the front office. It's really a small storefront done up to resemble an office. A store sales counter serves as a front desk, behind which are located shelves of office supplies and a row of drawers. There are also a couch and coffee table here creating a makeshift seating area. An old department store clothing rack serves as a coatrack. Photos on the walls picture the Bureau in better days. A stack of used and empty cardboard boxes sits in one corner.

The Bureau's latest office manager, Margaret is bustling around with unrestrained enthusiasm.

Also here is a blue flipphone.

The blue flipphone is ringing.

Faraji can ask about the status of the computer.

>e
Agent Faraji is at the south end of the strip mall parking lot. From here one can see just how humble BOSH's state has become: the office is to the west, between a pawn shop (to the southwest) and a run-down laundromat (to the northwest) and across from an automatic car wash. To the south is a swampy area separating the lot from the interstate. The parking lot continues north.

Their Hyundai is parked nearby.

A phone is ringing inside the front office.

>w
Agent Faraji is in the front office. It's really a small storefront done up to resemble an office. A store sales counter serves as a front desk, behind which are located shelves of office supplies and a row of drawers. There are also a couch and coffee table here creating a makeshift seating area. An old department store clothing rack serves as a coatrack. Photos on the walls picture the Bureau in better days. A stack of used and empty cardboard boxes sits in one corner.

The Bureau's latest office manager, Margaret is bustling around with unrestrained enthusiasm.

Also here is a blue flipphone.

The blue flipphone is ringing.

Faraji can ask about the status of the computer.

>w
Agent Faraji is in the hallway. Their office is to the south, Klimp's is to the west, and Moira's is to the north. The front office is east.

A phone is ringing to the east, in the front office.

>w
(first opening Klimp's door)
It seems to be locked.

A phone is ringing to the east, in the front office.

>take phone
There's nothing like that nearby.

>e
Agent Faraji is in the front office. It's really a small storefront done up to resemble an office. A store sales counter serves as a front desk, behind which are located shelves of office supplies and a row of drawers. There are also a couch and coffee table here creating a makeshift seating area. An old department store clothing rack serves as a coatrack. Photos on the walls picture the Bureau in better days. A stack of used and empty cardboard boxes sits in one corner.

The Bureau's latest office manager, Margaret is bustling around with unrestrained enthusiasm.

Also here is a blue flipphone.

The blue flipphone is ringing.

Faraji can ask about the status of the computer.

>take phone
Taken.

The blue flipphone you are carrying is ringing.

Faraji can ask about the status of the computer.

>e
Agent Faraji is at the south end of the strip mall parking lot. From here one can see just how humble BOSH's state has become: the office is to the west, between a pawn shop (to the southwest) and a run-down laundromat (to the northwest) and across from an automatic car wash. To the south is a swampy area separating the lot from the interstate. The parking lot continues north.

Their Hyundai is parked nearby.

The blue flipphone you are carrying is ringing.

>drop phone
Dropped.

The blue flipphone is ringing.

>in
Agent Faraji is in the front office. It's really a small storefront done up to resemble an office. A store sales counter serves as a front desk, behind which are located shelves of office supplies and a row of drawers. There are also a couch and coffee table here creating a makeshift seating area. An old department store clothing rack serves as a coatrack. Photos on the walls picture the Bureau in better days. A stack of used and empty cardboard boxes sits in one corner.

The Bureau's latest office manager, Margaret is bustling around with unrestrained enthusiasm.

A phone is ringing outside, at the south end of the strip mall parking lot.

Faraji can ask about the status of the computer.

>out
Agent Faraji is at the south end of the strip mall parking lot. From here one can see just how humble BOSH's state has become: the office is to the west, between a pawn shop (to the southwest) and a run-down laundromat (to the northwest) and across from an automatic car wash. To the south is a swampy area separating the lot from the interstate. The parking lot continues north.

Their Hyundai is parked nearby.

Also here is a blue flipphone.

The blue flipphone is ringing.

>n
Faraji trudges to the other end of the parking lot. It's much like where they left.

Agent Faraji is at the north end of the strip mall parking lot. This end is no more auspicious than the other. A convenience store lies to the east. To the west is a military recruitment center. North of here the parking lot exits onto a busy road. There is a rusty sign by the road naming the shopping center: Park Place. South is BOSH headquarters, among other things.

A phone is ringing to the south, at the south end of the strip mall parking lot.

>s
Faraji walks back to the south end of the parking lot.

Agent Faraji is at the south end of the strip mall parking lot. From here one can see just how humble BOSH's state has become: the office is to the west, between a pawn shop (to the southwest) and a run-down laundromat (to the northwest) and across from an automatic car wash. To the south is a swampy area separating the lot from the interstate. The parking lot continues north.

Their Hyundai is parked nearby.

Also here is a blue flipphone.

The blue flipphone is ringing.

>sw
(first opening the pawn shop door)
"Cha-ching!" rings the electronic chime as Faraji steps into the store.

Agent Faraji is in Dave's pawn shop. This is more the seedy, gloomy stereotype of a pawn shop than the glitzy sanitized version of TV reality shows. The blinds in the windows are closed to only allow the barest slant of sunlight in, leaving the sickly fluorescent lights to illuminate the room. There is the distinct smell of cigar smoke. The glass counter is filled with a large collection of possibly valuable items. Behind it is an impressive array of firearms.

A man, presumably Dave, stands behind the main counter eyeing Faraji.

A phone is ringing outside, at the south end of the strip mall parking lot.

The pawn shop door closes.

>l
Agent Faraji is in Dave's pawn shop. This is more the seedy, gloomy stereotype of a pawn shop than the glitzy sanitized version of TV reality shows. The blinds in the windows are closed to only allow the barest slant of sunlight in, leaving the sickly fluorescent lights to illuminate the room. There is the distinct smell of cigar smoke. The glass counter is filled with a large collection of possibly valuable items. Behind it is an impressive array of firearms.

A man, presumably Dave, stands behind the main counter eyeing Faraji.

A phone is ringing outside, at the south end of the strip mall parking lot.

>showme
Dave's pawn shop - room
    pawn shop door - shop-door
    Hyperlight - backdrop
    ceiling - backdrop
    floor - backdrop
    wall - backdrop
    Faraji - nonbinary
        Bureau credit card - money card
    pawn-light - light source
    Dave - man

>showme dave's
(Dave's pawn shop)
Dave's pawn shop - room
    pawn shop door - shop-door
    Hyperlight - backdrop
    ceiling - backdrop
    floor - backdrop
    wall - backdrop
    Faraji - nonbinary
        Bureau credit card - money card
    pawn-light - light source
    Dave - man
singular-named, proper-named, unmarked for special listing; lighted, visited, fully lit
list grouping key: none
printed name: "Dave's pawn shop"
printed plural name: none
indefinite article: none
most recent reference: nominal
third singular pronoun: It-pronoun
summary: none
description: "This is more the seedy, gloomy stereotype of a pawn shop than the glitzy sanitized version of TV reality shows. The blinds in the windows are closed to only allow the barest slant of sunlight in, leaving the sickly fluorescent lights to illuminate the room. There is the distinct smell of cigar smoke. The glass counter is filled with a large collection of possibly valuable items. Behind it is an impressive array of firearms."
map region: Swamp Park
dark description: none
reception: true
preposition: "in"
destination name: "Dave's pawn shop"
room condition: indoors

>out
Once again -- "Cha-ching!" -- as Faraji leaves the store.

Agent Faraji is at the south end of the strip mall parking lot. From here one can see just how humble BOSH's state has become: the office is to the west, between a pawn shop (to the southwest) and a run-down laundromat (to the northwest) and across from an automatic car wash. To the south is a swampy area separating the lot from the interstate. The parking lot continues north.

Their Hyundai is parked nearby.

Also here is a blue flipphone.

The blue flipphone is ringing.

>showme south parking
south end of the strip mall parking lot - room
    pawn shop door - shop-door
    Hyperlight - backdrop
    ceiling - backdrop
    floor - backdrop
    wall - backdrop
    Faraji - nonbinary
        Bureau credit card - money card
    blue flipphone - phone
    laundromat door - shop-door
    office - unenterable room
        Margaret (part of office)
        department store sign (part of office)
    their Hyundai
    A-plus laundromat - unenterable room
        laundromat sign (part of A-plus laundromat)
    swamp - unenterable room
    Dave's pawn shop - unenterable room
        flashing neon sign (part of Dave's pawn shop)
    automatic car wash - unenterable room
    interstate
singular-named, improper-named, unmarked for special listing; lighted, visited, fully lit
list grouping key: none
printed name: "south end of the strip mall parking lot"
printed plural name: none
indefinite article: none
most recent reference: nominal
third singular pronoun: It-pronoun
summary: none
description: "From here one can see just how humble BOSH's state has become: the office is to the west, between a pawn shop (to the southwest) and a run-down laundromat (to the northwest) and across from an automatic car wash. To the south is a swampy area separating the lot from the interstate. The parking lot continues north."
map region: Swamp Park
dark description: none
reception: true
preposition: "at"
destination name: none
room condition: outdoors

>w
Agent Faraji is in the front office. It's really a small storefront done up to resemble an office. A store sales counter serves as a front desk, behind which are located shelves of office supplies and a row of drawers. There are also a couch and coffee table here creating a makeshift seating area. An old department store clothing rack serves as a coatrack. Photos on the walls picture the Bureau in better days. A stack of used and empty cardboard boxes sits in one corner.

The Bureau's latest office manager, Margaret is bustling around with unrestrained enthusiasm.

A phone is ringing outside, at the south end of the strip mall parking lot.

Faraji can ask about the status of the computer.

>w
Agent Faraji is in the hallway. Their office is to the south, Klimp's is to the west, and Moira's is to the north. The front office is east.

>e
Agent Faraji is in the front office. It's really a small storefront done up to resemble an office. A store sales counter serves as a front desk, behind which are located shelves of office supplies and a row of drawers. There are also a couch and coffee table here creating a makeshift seating area. An old department store clothing rack serves as a coatrack. Photos on the walls picture the Bureau in better days. A stack of used and empty cardboard boxes sits in one corner.

The Bureau's latest office manager, Margaret is bustling around with unrestrained enthusiasm.

A phone is ringing outside, at the south end of the strip mall parking lot.

Faraji can ask about the status of the computer.

>w
Agent Faraji is in the hallway. Their office is to the south, Klimp's is to the west, and Moira's is to the north. The front office is east.

>w
(first opening Klimp's door)
It seems to be locked.

>s
Agent Faraji is in their office. It's basically four white walls and grey carpet. There's a cheap desk and chair, and a disconnected phone on the desk. In lieu of windows, there are a few things on the wall: their degree in Nonstandard Investigative Techniques, a pencil drawing of the Pitfall snake, and a photo of their softball team. The office door is to the north, and there's a white metal door to the west.

* * *

>out
Faraji steps out of the office into the parking lot.

Agent Faraji is at the south end of the strip mall parking lot. From here one can see just how humble BOSH's state has become: the office is to the west, between a pawn shop (to the southwest) and a run-down laundromat (to the northwest) and across from an automatic car wash. To the south is a swampy area separating the lot from the interstate. The parking lot continues north.

Their Hyundai is parked nearby.

A phone is ringing inside the front office.

>n
Faraji trudges to the other end of the parking lot. It's much like where they left.

Agent Faraji is at the north end of the strip mall parking lot. This end is no more auspicious than the other. A convenience store lies to the east. To the west is a military recruitment center. North of here the parking lot exits onto a busy road. There is a rusty sign by the road naming the shopping center: Park Place. South is BOSH headquarters, among other things.

>in
Faraji is greeted by a blast of music as they enter the store.

Agent Faraji is in the Li'l Nectarine Convenience Store. Li'l Nectarine offers great service and low prices, or so they say. This one's cluttered aisles and sparse shelves could make one wonder if that's true. Behind the counter is the typical array of cigarettes and lottery tickets. Under the counter is a glass case containing various useful items.

The clerk, a scruffy man in his mid-twenties, is leaning against the counter, looking bored.

>out
Faraji exits the store into the relative quiet of the nearby traffic.

Agent Faraji is at the north end of the strip mall parking lot. This end is no more auspicious than the other. A convenience store lies to the east. To the west is a military recruitment center. North of here the parking lot exits onto a busy road. There is a rusty sign by the road naming the shopping center: Park Place. South is BOSH headquarters, among other things.

>s
Faraji walks back to the south end of the parking lot.

Agent Faraji is at the south end of the strip mall parking lot. From here one can see just how humble BOSH's state has become: the office is to the west, between a pawn shop (to the southwest) and a run-down laundromat (to the northwest) and across from an automatic car wash. To the south is a swampy area separating the lot from the interstate. The parking lot continues north.

Their Hyundai is parked nearby.

A phone is ringinginside.

>nw
A sign on the laundromat door says "Closed for renovations".

A phone is ringinginside.

>sw
(first opening the pawn shop door)
"Cha-ching!" rings the electronic chime as Faraji steps into the store.

Agent Faraji is in Dave's pawn shop. This is more the seedy, gloomy stereotype of a pawn shop than the glitzy sanitized version of TV reality shows. The blinds in the windows are closed to only allow the barest slant of sunlight in, leaving the sickly fluorescent lights to illuminate the room. There is the distinct smell of cigar smoke. The glass counter is filled with a large collection of possibly valuable items. Behind it is an impressive array of firearms.

A man, presumably Dave, stands behind the main counter eyeing Faraji.

The pawn shop door closes.

>ne
(first opening the pawn shop door)
Once again -- "Cha-ching!" -- as Faraji leaves the store.

Agent Faraji is at the south end of the strip mall parking lot. From here one can see just how humble BOSH's state has become: the office is to the west, between a pawn shop (to the southwest) and a run-down laundromat (to the northwest) and across from an automatic car wash. To the south is a swampy area separating the lot from the interstate. The parking lot continues north.

Their Hyundai is parked nearby.

A phone is ringinginside.

The pawn shop door closes.

>w
Agent Faraji is in the front office. It's really a small storefront done up to resemble an office. A store sales counter serves as a front desk, behind which are located shelves of office supplies and a row of drawers. There are also a couch and coffee table here creating a makeshift seating area. An old department store clothing rack serves as a coatrack. Photos on the walls picture the Bureau in better days. A stack of used and empty cardboard boxes sits in one corner.

The Bureau's latest office manager, Margaret is bustling around with unrestrained enthusiasm.

Also here is a blue flipphone.

The blue flipphone is ringing.

Faraji can ask about the status of the computer.

>e
Agent Faraji is at the south end of the strip mall parking lot. From here one can see just how humble BOSH's state has become: the office is to the west, between a pawn shop (to the southwest) and a run-down laundromat (to the northwest) and across from an automatic car wash. To the south is a swampy area separating the lot from the interstate. The parking lot continues north.

Their Hyundai is parked nearby.

A phone is ringinginside.

>scope
1: Hyperlight (1093498)
2: a ceiling (1093402)
3: a floor (1093370)
4: a wall (1093338)
5: Faraji (1097466)
6: a pawn shop door (1095898)
7: a laundromat door (1095738)
8: an office (1095098)
9: Margaret (1095610)
10: a department store sign (1095642)
11: their Hyundai (1095130)
12: an A-plus laundromat (1095162)
13: a laundromat sign (1095706)
14: a swamp (1095194)
15: Dave's pawn shop (1095226)
16: a flashing neon sign (1095866)
17: an automatic car wash (1095258)
18: an interstate (1095290)
19: the Bureau credit card (1100090)

>x door
Which do you mean, the pawn shop door or the laundromat door?

>both
Sorry, you can only have one item here. Which exactly?

>pawn
It's a typical glass door. The light within is too dim to see much.

A phone is ringinginside.

>in
Agent Faraji is in the front office. It's really a small storefront done up to resemble an office. A store sales counter serves as a front desk, behind which are located shelves of office supplies and a row of drawers. There are also a couch and coffee table here creating a makeshift seating area. An old department store clothing rack serves as a coatrack. Photos on the walls picture the Bureau in better days. A stack of used and empty cardboard boxes sits in one corner.

The Bureau's latest office manager, Margaret is bustling around with unrestrained enthusiasm.

Also here is a blue flipphone.

The blue flipphone is ringing.

Faraji can ask about the status of the computer.

* * *

>ask margaret about desk
the front desk is the topic.

A phone is ringing not too far away.

>ask margaret about boxes
That doesn't seem to be a topic of conversation at the moment.

A phone is ringing not too far away.

>ask margaret about faraji
That doesn't seem to be a topic of conversation at the moment.

A phone is ringing not too far away.

>w
Faraji extricates themself from talking with Margaret.

Agent Faraji is in the hallway. Their office is to the south, Klimp's is to the west, and Moira's is to the north. The front office is east.

A phone is ringing to the south.

>s
Agent Faraji is in their office. They pause and survey the scene. It's not much -- four white walls, grey industrial carpet. Margaret has helpfully assembled Faraji's desk and chair, though how sturdily is an open question. She also took the time to put up some of Agent Faraji's office decor -- their degree in Nonstandard Investigative Techniques, an original pencil drawing of the Pitfall snake by semi-acclaimed Washington DC artist Darius 5200, and a photo of their softball team. At the very least the wall coverings help compensate for the lack of windows. There's a disconnected landline on the desk. The office door is to the north, and there's a white metal door to the west.

Faraji mutters, "Where's my computer?"

A phone is ringing inside Faraji's desk.

>open desk
Faraji tries to open the desk to answer the phone, but it seems to be locked. They sigh. "Margaret must have the key."

A phone is ringing inside their desk.

>n
Agent Faraji is in the hallway. Their office is to the south, Klimp's is to the west, and Moira's is to the north. The front office is east.

A phone is ringing to the south.

>e
Agent Faraji is in the front office. It's really a small storefront done up to resemble an office. A store sales counter serves as a front desk, behind which are located shelves of office supplies and a row of drawers. There are also a couch and coffee table here creating a makeshift seating area. An old department store clothing rack serves as a coatrack. Photos on the walls picture the Bureau in better days. A stack of used and empty cardboard boxes sits in one corner.

The Bureau's latest office manager, Margaret is bustling around with unrestrained enthusiasm.

A phone is ringing not too far away.

Faraji can ask about the whereabouts of the desk key or ask about the status of the computer.

>ask about desk key
Faraji says, "Hey Margaret, do you know anything about my desk key?"

"Sure I do -- I put it in your desk." She furrows her brow. "What's the matter?"

A phone is ringing not too far away.

Faraji can ask about the status of the computer.

>undo
front office
[Previous turn undone.]

>ask about key
Faraji says, "Hey Margaret, do you know anything about my desk key?"

"Sure I do -- I put it in your desk." She furrows her brow. "What's the matter?"

A phone is ringing not too far away.

Faraji can ask about the status of the computer.

>x office supplies
Pens, paper, nothing Faraji's really concerned with now.

A phone is ringing not too far away.

Faraji can ask about the status of the computer.

>x shelves
Pens, paper, nothing Faraji's really concerned with now.

A phone is ringing not too far away.

Faraji can ask about the status of the computer.

>scope
1: Hyperlight (1090593)
2: a ceiling (1090497)
3: a floor (1090465)
4: a wall (1090433)
5: Faraji (1094561)
6: Margaret (1092449)
7: a coffee table (1092481)
8: a couch (1092513)
9: a seating area (1092545)
10: a coatrack (1092577)
11: a front desk (1092609)
12: some shelves of office supplies (1092641)
13: some cardboard boxes (1092673)
14: the Bureau credit card (1097185)

* * *

>e
Faraji steps out of the office into the parking lot.

Agent Faraji is at the south end of the strip mall parking lot. From here one can see just how humble BOSH's state has become: the office is to the west, between a pawn shop (to the southwest) and a run-down laundromat (to the northwest) and across from an automatic car wash. To the south is a swampy area separating the lot from the interstate. The parking lot continues north.

Their Hyundai is parked nearby.

>wear lenses
There's nothing like that nearby.

* * *

>look behind desk
There are a number of shelves of office supplies behind the desk. There is also a heating vent on the floor here.

Faraji finds their computer and pulls it out.

A phone is ringing not too far away.

Faraji can ask about the phone exchange.

>x computer
Faraji's computer has been damaged beyond repair. But they do find a thumb drive and take it.

A phone is ringing not too far away.

Faraji can remember finding the drive.

>e
Faraji steps out of the office into the parking lot.

Agent Faraji is at the south end of the strip mall parking lot. From here one can see just how humble BOSH's state has become: the office is to the west, between a pawn shop (to the southwest) and a run-down laundromat (to the northwest) and across from an automatic car wash. To the south is a swampy area separating the lot from the interstate. The parking lot continues north.

Their Hyundai is parked nearby.

>gonear doris
Agent Faraji is in the field office chief's office. Doris's office

Doris is sitting cross-legged in a chair, tapping his foot lazily on the desk.

"Ah, Larch," Doris exclaims, standing up to shake their hand. "I've been waiting for you to pay us a visit. Did you bring the thumb drive?"

>hi
(addressing Doris)
Faraji can ask who he is, ask where we are, ask how to get home or show him the thumb drive.

>drop drive
Dropped.

Faraji can ask who he is, ask where we are, ask how to get home, tell Doris they don't have it or show him the thumb drive.

>show him the drive
(first taking the thumb drive)
Faraji answers, "Yes, I have it."

"Fantastic! Hand it here."

Faraji can ask who he is, ask where we are, ask how to get home or hand over the thumb drive.

* * *

>hi
(addressing Doris)
Faraji can ask who he is, ask where we are, ask how to get home or show him the thumb drive.

>e
Agent Faraji is in the field office hallway. Hallway

* * *

>drop drive
Dropped.

>w
Agent Faraji is in the field office chief's office. Doris's office

Doris is sitting cross-legged in a chair, tapping his foot lazily on the desk.

Faraji can ask who he is, ask where we are, ask how to get home, tell Doris they don't have it or show him the thumb drive.

>show him the drive
There's nothing like that nearby.

>w
Faraji can't go that way.

Faraji can ask who he is, ask where we are, ask how to get home, tell Doris they don't have it or show him the thumb drive.

>get drive
There's nothing like that nearby.

>e
Agent Faraji is in the field office hallway. Hallway

Also here is a thumb drive.

>get drive
Taken.

>w
Agent Faraji is in the field office chief's office. Doris's office

Doris is sitting cross-legged in a chair, tapping his foot lazily on the desk.

Faraji can ask who he is, ask where we are, ask how to get home or show him the thumb drive.

>show him the drive
Faraji answers, "Yes, I have it."

"Fantastic! Hand it here."

Faraji can ask who he is, ask where we are, ask how to get home or hand over the thumb drive.

>e
Agent Faraji is in the field office hallway. Hallway

* * *

>drop drive
Dropped.

>w
Agent Faraji is in the field office chief's office. Doris's office

Doris is sitting cross-legged in a chair, tapping his foot lazily on the desk.

Faraji can ask who he is, ask where we are, ask how to get home, tell Doris they don't have it or hand over the thumb drive.

>hand him the drive
Faraji doesn't have the thumb drive.

Faraji can ask who he is, ask where we are, ask how to get home, tell Doris they don't have it or hand over the thumb drive.

>hand over the drive
Faraji doesn't have the thumb drive.

They give the thumb drive to Doris.

"Great, great." He peruses the drive. "We lost one of our New York agents to a slingshot effect that threw him far back in time. We're always monitoring for artifacts that are out of place or anachronistic to lead us to lost agents.

He continues, "The scratch marks here say 'They found me out and sent me back. 14th century. Enigma Lake. Savra is going to move on the Dragon.'"

They can't reach into the field office hallway.

Faraji can ask who he is, ask where we are, ask how to get home, tell Doris they don't have it, ask about Savra, ask about the Dragon or ask about time travel.

* * *

>hand him the drive
Faraji doesn't have the thumb drive.

Faraji can ask who he is, ask where we are, ask how to get home, tell Doris they don't have it or hand over the thumb drive.

>w
Faraji can't go that way.

Faraji can ask who he is, ask where we are, ask how to get home, tell Doris they don't have it or hand over the thumb drive.

>e
Agent Faraji is in the field office hallway. Hallway

Also here is a thumb drive.

>take drive
Taken.

>w
Agent Faraji is in the field office chief's office. Doris's office

Doris is sitting cross-legged in a chair, tapping his foot lazily on the desk.

Faraji can ask who he is, ask where we are, ask how to get home or hand over the thumb drive.

>hand over the drive
Faraji gives the thumb drive to Doris.

"Great, great." He peruses the drive. "We lost one of our New York agents to a slingshot effect that threw him far back in time. We're always monitoring for artifacts that are out of place or anachronistic to lead us to lost agents.

He continues, "The scratch marks here say 'They found me out and sent me back. 14th century. Enigma Lake. Savra is going to move on the Dragon.'"

Faraji can ask who he is, ask where we are, ask how to get home, ask about Savra, ask about the Dragon or ask about time travel.

* * *

>hi
(addressing Doris)
Faraji can ask who he is, ask where we are, ask how to get home or show him the thumb drive.

>how can i get home
Faraji asks, "Just how can I get home from here?"

Doris hardly looks up from his work. "Go ask Maggie; she can help you."

Faraji can ask who he is, ask where we are or show him the thumb drive.

>show him
What do you want to show Doris?

>thumb drive
Faraji answers, "Yes, I have it."

"Fantastic! Hand it here."

Faraji can ask who he is, ask where we are or hand over the thumb drive.

>hand it over
Faraji gives the thumb drive to Doris.

"Great, great." He peruses the drive. "We lost one of our New York agents to a slingshot effect that threw him far back in time. We're always monitoring for artifacts that are out of place or anachronistic to lead us to lost agents.

He continues, "The scratch marks here say 'They found me out and sent me back. 14th century. Enigma Lake. Savra is going to move on the Dragon.'"

Faraji can ask who he is, ask where we are, ask about Savra, ask about the Dragon or ask about time travel.

* * *

>hi
(addressing Doris)
Faraji can ask who he is, ask where we are, ask how to get home or show him the thumb drive.

>who are you
Faraji asks "Who are you?"

He looks taken aback for a moment, then recovers his composure. "Ah yes, introductions. I'm Doris, chief of the hyperspatial field office of the Bureau."

Faraji can ask where we are, ask how to get home or show him the thumb drive.

>ask where we are
Faraji looks around and asks, "Where are we? What is this place?"

Doris answers, "You're in the hyperspatial field office of the Bureau of Strange Happenings. But I guess that doesn't exactly clear things up for you. 

Faraji can ask how to get home or show him the thumb drive.

* * *

>show him the drive
Faraji answers, "Yes, I have it."

"Fantastic! Hand it here."

Faraji can hand over the thumb drive.

>hand it over
Faraji gives the thumb drive to Doris.

"Great, great." He peruses the drive. "We lost one of our New York agents to a slingshot effect that threw him far back in time. We're always monitoring for artifacts that are out of place or anachronistic to lead us to lost agents.

He continues, "The scratch marks here say 'They found me out and sent me back. 14th century. Enigma Lake. Savra is going to move on the Dragon.'"

Faraji can ask about Savra, ask about the Dragon or ask about time travel.

>ask about savra
Faraji can ask about the Dragon or ask about time travel.

>time travel
Faraji can ask about the Dragon.

* * *

>look behind desk
There are a number of shelves of office supplies behind the desk. There is also a heating vent on the floor here.

Faraji finds their computer and pulls it out.

A phone is ringing not too far away.

Faraji can ask about the phone exchange.

>x vent
A typical air register with a grill which one would hope would stop things like, say, a hex wrench from falling through. It's set in the floor behind the front desk. The vent is held closed by four screws.

In the heating vent is a hex wrench.

A phone is ringing not too far away.

Faraji can ask for a screwdriver or ask about the phone exchange.

>e
Faraji steps out of the office into the parking lot.

Agent Faraji is at the south end of the strip mall parking lot. From here one can see just how humble BOSH's state has become: the office is to the west, between a pawn shop (to the southwest) and a run-down laundromat (to the northwest) and across from an automatic car wash. To the south is a swampy area separating the lot from the interstate. The parking lot continues north.

Their Hyundai is parked nearby.

* * *

>e
Faraji is greeted by a blast of music as they enter the store.

Agent Faraji is in the Li'l Nectarine Convenience Store. Li'l Nectarine offers great service and low prices, or so they say. This one's cluttered aisles and sparse shelves could make one wonder if that's true. Behind the counter is the typical array of cigarettes and lottery tickets. Under the counter is a glass case containing various useful items.

The clerk, a scruffy man in his mid-twenties, is leaning against the counter, looking bored.

>ask for a screwdriver
That doesn't seem to be a topic of conversation at the moment.

>ask for a screwdriver
That doesn't seem to be a topic of conversation at the moment.

>ask about screwdriver
"I'll sell it for $5."

>x case
In the glass case are a flashlight, a red screwdriver, a laptop computer and some wireless earbuds.

>ask about screwdriver
"I'll sell it for $5."

>ask about red
"I'll sell it for $5."

>ask about light
"I'll sell it for $5."

>ask about screwdriver
"I'll sell it for $5."

>ask about case
Faraji says, "Tell me about the glass case."

"You want something inside, just ask."

>ask about buds
That doesn't seem to be a topic of conversation at the moment.

>ask about earbuds
"I'll sell them for $85."

>i
Faraji is carrying:
  the Bureau credit card

>buy earbuds
(with the Bureau credit card)
The store clerk runs the Bureau credit card, but it's declined. You might want to call the bank.

>purloin bill
There seems to be no such object anywhere in the model world.

>purloin $20
There seems to be no such object anywhere in the model world.

>purloin 20
There seems to be no such object anywhere in the model world.

* * *

>s
Faraji can't go that way.

A phone is ringing somewhere else not too far away.

Faraji can ask about the phone exchange.

>sit in chair
There's nothing like that nearby.

>take their chair
There's nothing like that nearby.

>get off
Faraji steps out of the office into the parking lot.

Agent Faraji is at the south end of the strip mall parking lot. From here one can see just how humble BOSH's state has become: the office is to the west, between a pawn shop (to the southwest) and a run-down laundromat (to the northwest) and across from an automatic car wash. To the south is a swampy area separating the lot from the interstate. The parking lot continues north.

Their Hyundai is parked nearby.

>sit on chair
There's nothing like that nearby.

>l
Agent Faraji is at the south end of the strip mall parking lot. From here one can see just how humble BOSH's state has become: the office is to the west, between a pawn shop (to the southwest) and a run-down laundromat (to the northwest) and across from an automatic car wash. To the south is a swampy area separating the lot from the interstate. The parking lot continues north.

Their Hyundai is parked nearby.

>x faraji's chair
There's nothing like that nearby.

>open desk
There's nothing like that nearby.

>open desk
There's nothing like that nearby.

>w
Agent Faraji is in the front office. It's really a small storefront done up to resemble an office. A store sales counter serves as a front desk, behind which are located shelves of office supplies and a row of drawers. There are also a couch and coffee table here creating a makeshift seating area. An old department store clothing rack serves as a coatrack. Photos on the walls picture the Bureau in better days. A stack of used and empty cardboard boxes sits in one corner.

The Bureau's latest office manager, Margaret is bustling around with unrestrained enthusiasm.

A phone is ringing somewhere else not too far away.

Faraji can ask about the phone exchange.

>x door
There's nothing like that nearby.

>metal
I'm not sure what you're trying to say. I might just not recognize the words you're using.

>m
I'm not sure what you're trying to say. I might just not recognize the words you're using.

>n
Faraji can't go that way.

A phone is ringing somewhere else not too far away.

Faraji can ask about the phone exchange.

>e
Agent Faraji is at the south end of the strip mall parking lot. From here one can see just how humble BOSH's state has become: the office is to the west, between a pawn shop (to the southwest) and a run-down laundromat (to the northwest) and across from an automatic car wash. To the south is a swampy area separating the lot from the interstate. The parking lot continues north.

Their Hyundai is parked nearby.

>unlock door
Which do you mean, the pawn shop door or the laundromat door?

>unlock backdoor
There's nothing like that nearby.

>ask unlock backdoora
I'm not sure what you're trying to say. I might just not recognize the words you're using.

>ask unlock backdoor
I'm not sure what you're trying to say. I might just not recognize the words you're using.

>undo
south end of the strip mall parking lot
[Previous turn undone.]

>ask her to unlock the backdoor
I'm not sure what you're trying to say. I might just not recognize the words you're using.

>break down boxes
There's nothing like that nearby.

>restart
Are you sure you want to restart?

>y
The Bureau of Strange Happenings
An Interactive Phenomenon by Phil Riley
Release 1 / Serial number 230617 / Inform 7 build 6M62 (I6/v6.34 lib 6/12N) SD

Agent Faraji is at the south end of the strip mall parking lot. From here one can see just how humble BOSH's state has become: the office is to the west, between a pawn shop (to the southwest) and a run-down laundromat (to the northwest) and across from an automatic car wash. To the south is a swampy area separating the lot from the interstate. The parking lot continues north.

Their Hyundai is parked nearby.

>break down boxes
There's nothing like that nearby.

>w
Just like in the store this once was, the door chimes as Faraji walks in.

Agent Faraji is in the front office. It's really a small storefront done up to resemble an office. A store sales counter serves as a front desk, behind which are located shelves of office supplies and a row of drawers. There are also a couch and coffee table here creating a makeshift seating area. An old department store clothing rack serves as a coatrack. Photos on the walls picture the Bureau in better days. A stack of used and empty cardboard boxes sits in one corner.

The Bureau's latest office manager, Margaret is bustling around with unrestrained enthusiasm, unpacking boxes and assembling an approximation of a respectable front office, all as if the Bureau isn't going to be shut down before the year is out. She sees Faraji and practically squeals. "Agent Faraji! I'm sorry -- Larch! How are you? I hope you don't mind -- I took the liberty of putting your desk together. I just love hex wrenches, don't you? Also, your new phone is here. I put it in your desk. Now I just need you to give me your old phone so I can deactivate it."

Faraji hands Margaret their old phone. Margaret taps a few keys on her computer and says "There! All settled."

"Oh, good", Faraji says. "Our phone downgrades have arrived from our bureaucratic betters."

A phone is ringing somewhere else not too far away.

Faraji can ask about the phone exchange.

>s
Faraji can't go that way.

A phone is ringing somewhere else not too far away.

Faraji can ask about the phone exchange.

>w
Faraji extricates themself from talking with Margaret.

Agent Faraji is in the hallway. Their office is to the south, Klimp's is to the west, and Moira's is to the north. The front office is east.

A phone is ringing to the south.

>e
Agent Faraji is in the front office. It's really a small storefront done up to resemble an office. A store sales counter serves as a front desk, behind which are located shelves of office supplies and a row of drawers. There are also a couch and coffee table here creating a makeshift seating area. An old department store clothing rack serves as a coatrack. Photos on the walls picture the Bureau in better days. A stack of used and empty cardboard boxes sits in one corner.

The Bureau's latest office manager, Margaret is bustling around with unrestrained enthusiasm.

A phone is ringing somewhere else not too far away.

Faraji can ask about the phone exchange.

>n
Faraji can't go that way.

A phone is ringing somewhere else not too far away.

Faraji can ask about the phone exchange.

>e
Faraji steps out of the office into the parking lot.

Agent Faraji is at the south end of the strip mall parking lot. From here one can see just how humble BOSH's state has become: the office is to the west, between a pawn shop (to the southwest) and a run-down laundromat (to the northwest) and across from an automatic car wash. To the south is a swampy area separating the lot from the interstate. The parking lot continues north.

Their Hyundai is parked nearby.

>z
Faraji stands around and waits.

>e
An automatic car wash isn't of much use when one is on foot.

>w
Agent Faraji is in the front office. It's really a small storefront done up to resemble an office. A store sales counter serves as a front desk, behind which are located shelves of office supplies and a row of drawers. There are also a couch and coffee table here creating a makeshift seating area. An old department store clothing rack serves as a coatrack. Photos on the walls picture the Bureau in better days. A stack of used and empty cardboard boxes sits in one corner.

The Bureau's latest office manager, Margaret is bustling around with unrestrained enthusiasm.

A phone is ringing somewhere else not too far away.

Faraji can ask about the phone exchange.

>w
Agent Faraji is in the hallway. Their office is to the south, Klimp's is to the west, and Moira's is to the north. The front office is east.

A phone is ringing to the south.

>s
Agent Faraji is in their office. They pause and survey the scene. It's not much -- four white walls, grey industrial carpet. Margaret has helpfully assembled Faraji's desk and chair, though how sturdily is an open question. She also took the time to put up some of Agent Faraji's office decor -- their degree in Nonstandard Investigative Techniques, an original pencil drawing of the Pitfall snake by semi-acclaimed Washington DC artist Darius 5200, and a photo of their soccer team. At the very least the wall coverings help compensate for the lack of windows. There's a disconnected landline on the desk. The office door is to the north, and there's a white metal door to the west.

Faraji mutters, "Where's my computer?"

A phone is ringing inside their desk.

>w
(first opening the white metal door)
It seems to be locked.

A phone is ringing inside Faraji's desk.

>n
Agent Faraji is in the hallway. Their office is to the south, Klimp's is to the west, and Moira's is to the north. The front office is east.

A phone is ringing to the south, in their office.

>e
Agent Faraji is in the front office. It's really a small storefront done up to resemble an office. A store sales counter serves as a front desk, behind which are located shelves of office supplies and a row of drawers. There are also a couch and coffee table here creating a makeshift seating area. An old department store clothing rack serves as a coatrack. Photos on the walls picture the Bureau in better days. A stack of used and empty cardboard boxes sits in one corner.

The Bureau's latest office manager, Margaret is bustling around with unrestrained enthusiasm.

A phone is ringing somewhere else not too far away.

Faraji can ask about the status of the computer, ask to unlock the backdoor or ask about the phone exchange.

>ask to unlock the backdoor
Faraji asks, "Could you unlock the back door, Margaret?"

"Sorry, too busy right now. What do you want back there anyway? There's only a dumpster." She pauses for a moment and mutters to herself. "Which reminds me, I need to get these boxes broken down."

A phone is ringing somewhere else not too far away.

Faraji can ask about the status of the computer or ask about the phone exchange.

* * *

>take boxes
Faraji picks up a couple of boxes and flattens them.

Margaret says, "Hey, what are you doing with those boxes, Agent Faraji? You don't have to worry about that -- I'll get them." She takes the flattened boxes from Faraji and hustles off.

A phone is ringing somewhere else not too far away.

Margaret goes west.

>w
Agent Faraji is in the hallway. Their office is to the south, Klimp's is to the west, and Moira's is to the north. The front office is east.

Also here is Margaret.

A phone is ringing to the south.

Margaret goes south.

>s
Agent Faraji is in their office. They pause and survey the scene. It's not much -- four white walls, grey industrial carpet. Margaret has helpfully assembled Faraji's desk and chair, though how sturdily is an open question. She also took the time to put up some of Agent Faraji's office decor -- their degree in Nonstandard Investigative Techniques, an original pencil drawing of the Pitfall snake by semi-acclaimed Washington DC artist Darius 5200, and a photo of their soccer team. At the very least the wall coverings help compensate for the lack of windows. There's a disconnected landline on the desk. The office door is to the north, and there's a white metal door to the west.

Faraji mutters, "Where's my computer?"

A phone is ringing inside their desk.

Margaret unlocks the white metal door.

Faraji can ask about the status of the computer or ask about the phone exchange.

>w
(first opening the white metal door)
Agent Faraji is in the back lot. This is a small area of asphalt between the building and a chain link fence looking in on an industrial property. A door to east leads into the BOSH offices, and one to the north enters the laundromat. There is a blue dumpster here.

A phone is ringing to the east, in their office.

Margaret arrives from the east.

>e
Agent Faraji is in their office. The room is basically four white walls and grey carpet. There's a cheap desk and chair, and a disconnected phone on the desk. In lieu of windows, there are a few things on the wall: their degree in Nonstandard Investigative Techniques, a pencil drawing of the Pitfall snake, and a photo of their soccer team. The office door is to the north, and there's a white metal door to the west.

A phone is ringing inside their desk.

>n
Agent Faraji is in the hallway. Their office is to the south, Klimp's is to the west, and Moira's is to the north. The front office is east.

A phone is ringing to the south, in their office.

>e
Agent Faraji is in the front office. It's really a small storefront done up to resemble an office. A store sales counter serves as a front desk, behind which are located shelves of office supplies and a row of drawers. There are also a couch and coffee table here creating a makeshift seating area. An old department store clothing rack serves as a coatrack. Photos on the walls picture the Bureau in better days. A stack of used and empty cardboard boxes sits in one corner.

A phone is ringing somewhere else not too far away.

>z
Faraji stands around and waits.

A phone is ringing somewhere else not too far away.

>z
Faraji stands around and waits.

A phone is ringing somewhere else not too far away.

Margaret arrives from the west.

Faraji can ask about the status of the computer or ask about the phone exchange.

>e
Faraji steps out of the office into the parking lot.

Agent Faraji is at the south end of the strip mall parking lot. From here one can see just how humble BOSH's state has become: the office is to the west, between a pawn shop (to the southwest) and a run-down laundromat (to the northwest) and across from an automatic car wash. To the south is a swampy area separating the lot from the interstate. The parking lot continues north.

Their Hyundai is parked nearby.

* * *

>n
Faraji trudges to the other end of the parking lot. It's much like where they left.

Agent Faraji is at the north end of the strip mall parking lot. This end is no more auspicious than the other. A convenience store lies to the east. To the west is a military recruitment center. North of here the parking lot exits onto a busy road. There is a rusty sign by the road naming the shopping center: Park Place. South is BOSH headquarters, among other things.

>s
Faraji walks back to the south end of the parking lot.

Agent Faraji is at the south end of the strip mall parking lot. From here one can see just how humble BOSH's state has become: the office is to the west, between a pawn shop (to the southwest) and a run-down laundromat (to the northwest) and across from an automatic car wash. To the south is a swampy area separating the lot from the interstate. The parking lot continues north.

Their Hyundai is parked nearby.

>w
Agent Faraji is in the front office. It's really a small storefront done up to resemble an office. A store sales counter serves as a front desk, behind which are located shelves of office supplies and a row of drawers. There are also a couch and coffee table here creating a makeshift seating area. An old department store clothing rack serves as a coatrack. Photos on the walls picture the Bureau in better days. A stack of used and empty cardboard boxes sits in one corner.

The Bureau's latest office manager, Margaret is bustling around with unrestrained enthusiasm.

A phone is ringing somewhere else not too far away.

Faraji can ask about the status of the computer or ask about the phone exchange.

>w
Agent Faraji is in the hallway. Their office is to the south, Klimp's is to the west, and Moira's is to the north. The front office is east.

A phone is ringing to the south, in their office.

>s
Agent Faraji is in their office. The room is basically four white walls and grey carpet. There's a cheap desk and chair, and a disconnected phone on the desk. In lieu of windows, there are a few things on the wall: their degree in Nonstandard Investigative Techniques, a pencil drawing of the Pitfall snake, and a photo of their soccer team. The office door is to the north, and there's a white metal door to the west.

A phone is ringing inside their desk.

>w
(first opening the white metal door)
It seems to be locked.

A phone is ringing inside Faraji's desk.

* * *

>n
Agent Faraji is in the hallway. Their office is to the south, Klimp's is to the west, and Moira's is to the north. The front office is east.

A phone is ringing to the south, in their office.

>e
Agent Faraji is in the front office. It's really a small storefront done up to resemble an office. A store sales counter serves as a front desk, behind which are located shelves of office supplies and a row of drawers. There are also a couch and coffee table here creating a makeshift seating area. An old department store clothing rack serves as a coatrack. Photos on the walls picture the Bureau in better days. A stack of used and empty cardboard boxes sits in one corner.

The Bureau's latest office manager, Margaret is bustling around with unrestrained enthusiasm.

A phone is ringing somewhere else not too far away.

Faraji can ask about the status of the computer or ask about the phone exchange.

>third
I'm not sure what you're trying to say. I might just not recognize the words you're using.

>enigma
Agent Faraji is in the Enigma Lake town hall. This is the lobby. The rest of the building is locked up tight. The main feature here is the information desk. Taped to it is what looks to be a work schedule.

Faraji can ask about the status of the computer or ask about the phone exchange.

>e
Faraji can't go that way.

Faraji can ask about the status of the computer or ask about the phone exchange.

>n
Agent Faraji is in Enigma Park. It's probably beautiful during the day, but tonight the deep shadows among the trees seem ominous. They are watchful and tense as they explore the park.

The central focus of the park is a large obelisk inscribed with the names of the town's citizens lost in the Great War.

Faraji can ask about the status of the computer or ask about the phone exchange.

>e
Agent Faraji is in Lake Street by the Park. 

Faraji can ask about the status of the computer or ask about the phone exchange.

* * *

>w
Faraji extricates themself from talking with Margaret.

Agent Faraji is in the hallway. Their office is to the south, Klimp's is to the west, and Moira's is to the north. The front office is east.

A phone is ringing to the south.

>e
Agent Faraji is in the front office. It's really a small storefront done up to resemble an office. A store sales counter serves as a front desk, behind which are located shelves of office supplies and a row of drawers. There are also a couch and coffee table here creating a makeshift seating area. An old department store clothing rack serves as a coatrack. Photos on the walls picture the Bureau in better days. A stack of used and empty cardboard boxes sits in one corner.

The Bureau's latest office manager, Margaret is bustling around with unrestrained enthusiasm.

A phone is ringing not too far away.

Faraji can ask about-the-phone-exchange.

>w
Agent Faraji is in the hallway. Their office is to the south, Klimp's is to the west, and Moira's is to the north. The front office is east.

A phone is ringing to the south.

>s
Agent Faraji is in their office. They pause and survey the scene. It's not much -- four white walls, grey industrial carpet. Margaret has helpfully assembled Faraji's desk and chair, though how sturdily is an open question. She also took the time to put up some of Agent Faraji's office decor -- their degree in Nonstandard Investigative Techniques, an original pencil drawing of the Pitfall snake by semi-acclaimed Washington DC artist Darius 5200, and a photo of their softball team. At the very least the wall coverings help compensate for the lack of windows. There's a disconnected landline on the desk. The office door is to the north, and there's a white metal door to the west.

Faraji mutters, "Where's my computer?"

A phone is ringing inside Faraji's desk.

>n
Agent Faraji is in the hallway. Their office is to the south, Klimp's is to the west, and Moira's is to the north. The front office is east.

A phone is ringing to the south, in Faraji's office.

>e
Agent Faraji is in the front office. It's really a small storefront done up to resemble an office. A store sales counter serves as a front desk, behind which are located shelves of office supplies and a row of drawers. There are also a couch and coffee table here creating a makeshift seating area. An old department store clothing rack serves as a coatrack. Photos on the walls picture the Bureau in better days. A stack of used and empty cardboard boxes sits in one corner.

The Bureau's latest office manager, Margaret is bustling around with unrestrained enthusiasm.

A phone is ringing not too far away.

Faraji can ask about the status of the computer or ask about-the-phone-exchange.

>ask about computer
"Margaret", Faraji says, "what's up with my computer?"

"Oh, it got busted up during the move. I have it behind my desk -- you can see it if you want. We'll have to get you a new one."

A phone is ringing not too far away.

Faraji can ask about-the-phone-exchange.

>look behind desk
There are a number of shelves of office supplies behind the desk. There is also a heating vent on the floor here.

Faraji finds their computer and pulls it out.

A phone is ringing not too far away.

Faraji can ask about-the-phone-exchange.

>look in vent
In the heating vent is a hex wrench.

A phone is ringing not too far away.

Faraji can ask about-the-phone-exchange.

>take wrench
Faraji's fingers won't fit through the openings in the vent. They"ll have to open it first.

A phone is ringing not too far away.

Faraji can ask about-the-phone-exchange.

>open vent
The vent is held closed by four screws.

A phone is ringing not too far away.

Faraji can ask for a screwdriver or ask about-the-phone-exchange.

>ask for a screwdriver
Faraji asks, "Margaret, where's the screwdriver?"

"Umm... I think it was in a box we had to leave behind." Margaret looks embarrassed. "What? I never thought we'd need it. This isn't a construction site after all. Maybe if Klimp had paid for the bigger UHaul..." She stares past Faraji awkwardly.

A phone is ringing not too far away.

Faraji can ask for a screwdriver or ask about-the-phone-exchange.

>w
Agent Faraji is in the hallway. Their office is to the south, Klimp's is to the west, and Moira's is to the north. The front office is east.

A phone is ringing to the south, in Faraji's office.

>e
Agent Faraji is in the front office. It's really a small storefront done up to resemble an office. A store sales counter serves as a front desk, behind which are located shelves of office supplies and a row of drawers. There are also a couch and coffee table here creating a makeshift seating area. An old department store clothing rack serves as a coatrack. Photos on the walls picture the Bureau in better days. A stack of used and empty cardboard boxes sits in one corner.

The Bureau's latest office manager, Margaret is bustling around with unrestrained enthusiasm.

Also here is Faraji's computer.

A phone is ringing not too far away.

Faraji can ask for a screwdriver or ask about-the-phone-exchange.

>e
Faraji steps out of the office into the parking lot.

Agent Faraji is at the south end of the strip mall parking lot. From here one can see just how humble BOSH's state has become: the office is to the west, between a pawn shop (to the southwest) and a run-down laundromat (to the northwest) and across from an automatic car wash. To the south is a swampy area separating the lot from the interstate. The parking lot continues north.

Their Hyundai is parked nearby.

>sw
(first opening the pawn shop door)
"Cha-ching!" rings the electronic chime as Faraji steps into the store.

Agent Faraji is in Dave's pawn shop. This is more the seedy, gloomy stereotype of a pawn shop than the glitzy sanitized version of TV reality shows. The blinds in the windows are closed to only allow the barest slant of sunlight in, leaving the sickly fluorescent lights to illuminate the room. There is the distinct smell of cigar smoke. The glass counter is filled with a large collection of possibly valuable items. Behind it is an impressive array of firearms.

A man, presumably Dave, stands behind the main counter eyeing Faraji.

The pawn shop door closes.

Faraji can ask for a screwdriver.

>ask for a screwdriver
Faraji leans on the counter. "Hey, do you have a screwdriver? Can't find mine and I really need one."

The man shakes his head and says, "Sorry, miss. I had one, but the guy who runs the laundromat borrowed it and didn't bring it back."

Faraji can ask about the laundromat owner.

>nw
Faraji can't go that way.

Faraji can ask about the laundromat owner.

>ne
(first opening the pawn shop door)
Once again -- "Cha-ching!" -- as Faraji leaves the store.

Agent Faraji is at the south end of the strip mall parking lot. From here one can see just how humble BOSH's state has become: the office is to the west, between a pawn shop (to the southwest) and a run-down laundromat (to the northwest) and across from an automatic car wash. To the south is a swampy area separating the lot from the interstate. The parking lot continues north.

Their Hyundai is parked nearby.

The pawn shop door closes.

>sw
(first opening the pawn shop door)
Agent Faraji is in Dave's pawn shop. This is more the seedy, gloomy stereotype of a pawn shop than the glitzy sanitized version of TV reality shows. The blinds in the windows are closed to only allow the barest slant of sunlight in, leaving the sickly fluorescent lights to illuminate the room. There is the distinct smell of cigar smoke. The glass counter is filled with a large collection of possibly valuable items. Behind it is an impressive array of firearms.

A man, presumably Dave, stands behind the main counter eyeing Faraji.

The pawn shop door closes.

Faraji can ask about the laundromat owner.

>ask about owner
Faraji nods. "Okay, then, how do I get in touch with this laundromat guy?"

"Well, that's a tricky one. Laundromat's been closed for almost two weeks now, since the owner just split for some reason he didn't bother to share. Not likely to get ahold of him. If you're not averse to a little trespassing, though, see if you come across a watch. Another thing he borrowed."

>ne
(first opening the pawn shop door)
Agent Faraji is at the south end of the strip mall parking lot. From here one can see just how humble BOSH's state has become: the office is to the west, between a pawn shop (to the southwest) and a run-down laundromat (to the northwest) and across from an automatic car wash. To the south is a swampy area separating the lot from the interstate. The parking lot continues north.

Klimp's Porsche takes up two spots.

Their Hyundai is parked nearby.

The pawn shop door closes.

>x porsche
Klimp drives an impeccably-maintained 2017 Porsche 911 Turbo Cabriolet.

>w
Agent Faraji is in the front office. It's really a small storefront done up to resemble an office. A store sales counter serves as a front desk, behind which are located shelves of office supplies and a row of drawers. There are also a couch and coffee table here creating a makeshift seating area. An old department store clothing rack serves as a coatrack. Photos on the walls picture the Bureau in better days. A stack of used and empty cardboard boxes sits in one corner.

The Bureau's latest office manager, Margaret is bustling around with unrestrained enthusiasm.

Also here is Faraji's computer.

A phone is ringing not too far away.

Faraji can ask for a screwdriver or ask about-the-phone-exchange.

>ask about klimp
Where's the Chief?"

Margaret points towards the hall. "He's in his office."

A phone is ringing not too far away.

Faraji can ask for a screwdriver or ask about-the-phone-exchange.

>ask about moira
Faraji says, "Has Moira come in yet?"

Margaret barely looks up from her work. "Nope."

A phone is ringing not too far away.

Faraji can ask for a screwdriver or ask about-the-phone-exchange.

>w
Agent Faraji is in the hallway. Their office is to the south, Klimp's is to the west, and Moira's is to the north. The front office is east.

A phone is ringing to the south, in Faraji's office.

>x moira's door
There seems to be nothing special about it.

A phone is ringing to the south, in Faraji's office.

>w
Agent Faraji is in the BOSH chief's office. Looks like the Chief has already moved in.

Chief Klimp's office is full of character. Shelves strewn with knick-knacks abut a cozy armchair and a mahogany side table supporting a large globe. A bookcase on the north wall is packed with books on paranormal happenings. Garish prints adorn the remaining wall space.  Under one of these is a modernistic desk of glass and chrome, behind which is a very nice black leather swivel chair. There is a computer on the desk, and to its side is an antique wooden file cabinet. To tell the truth, it's all a bit much, but it matches Klimp's personality perfectly. There is an exit to the east.

Chief Klimp says "What's with that ringing? Someone answer it!"

On the Chief's shelves are a juvenile sasquatch skull and a pair of astral lenses.

A phone is ringing not too far away.

>x lenses
To all appearances an ordinary pair of glasses, the astral lenses allegedly reveal the existence of extra-dimensional pathways.

A phone is ringing not too far away.

Faraji can ask to borrow the lenses.

>ask to borrow
Faraji asks, "Would it be okay if I borrowed the astral lenses for a while?"

"Sure! Why don't you scout the locality for astral phenomena?"

They take the astral lenses.

A phone is ringing not too far away.

>wear tje,
There's nothing like that nearby.

>wear them
Faraji puts on the pair of astral lenses.

A phone is ringing not too far away.

>l
Agent Faraji is in the BOSH chief's office. Chief Klimp's office is full of character. Shelves strewn with knick-knacks abut a cozy armchair and a mahogany side table supporting a large globe. A bookcase on the north wall is packed with books on paranormal happenings. Garish prints adorn the remaining wall space.  Under one of these is a modernistic desk of glass and chrome, behind which is a very nice black leather swivel chair. There is a computer on the desk, and to its side is an antique wooden file cabinet. To tell the truth, it's all a bit much, but it matches Klimp's personality perfectly. There is an exit to the east.

On the Chief's shelves is a juvenile sasquatch skull.

Also here is Chief Klimp.

A phone is ringing not too far away.

>remove lenses
Faraji takes off the pair of astral lenses.

A phone is ringing not too far away.

>gonear back lot
Agent Faraji is in the back lot. This is a small area of asphalt between the building and a chain link fence looking in on an industrial property. A door to east leads into the BOSH offices, and one to the north enters the laundromat. There is a blue dumpster here.

>hi
There's no one here but Faraji.

>goodbye
Faraji isn't talking to anyone.

>wear lenses
Faraji puts on the pair of astral lenses.

>l
Agent Faraji is in the back lot. This is a small area of asphalt between the building and a chain link fence looking in on an industrial property. A door to east leads into the BOSH offices, and one to the north enters the laundromat. There is a blue dumpster here.

A strange sparkly white passage branches off in an impossible direction from here.

Faraji has discovered a hyperspatial tunnel! It leads in the hyperspatial direction of "back".
For help regarding hyperspace, enter HELP HYPERSPACE.

>l
Agent Faraji is in the back lot. This is a small area of asphalt between the building and a chain link fence looking in on an industrial property. A door to east leads into the BOSH offices, and one to the north enters the laundromat. There is a blue dumpster here.

A hyperspatial tunnel leads in the direction of "back".

>remove lenses
Faraji takes off the pair of astral lenses.

>z
Faraji stands around and waits.

>wear lenses
Faraji puts on the pair of astral lenses.

>b
Agent Faraji is in the astral tunnel. It is featureless white, or what passes for white here. It bends "forth" to north.

>help hyperspace
Hyperspace is a four-dimensional plane of being overlaying our own three-dimensional plane. The familiar directions (north, south, up, northeast, etc.) work there, as do two new directions "back" and "forth", and their combinations with our compass directions: forthnorth, backeast, etc. These can be abbreviated just as compass directions can: b, f, fn, be, and so on.

>n
Agent Faraji is in the astral tunnel. It is featureless white, or what passes for white here. It bends south to "forth."

>f
Agent Faraji is in the laundromat back room. A desk sits in the corner covered with paperwork. A doorway leads east to the laundromat proper, while a steep set of stairs leads down.

A hyperspatial tunnel leads in the direction of "back".

Wearing the astral lenses in fluorescent light is blinding. Faraji quickly removes the glasses.

>x desk
There's nothing like that nearby.

>b
Faraji can't go that way.

>l
Agent Faraji is in the laundromat back room. A desk sits in the corner covered with paperwork. A doorway leads east to the laundromat proper, while a steep set of stairs leads down.

>d
Agent Faraji is in the laundromat basement. A few boxes of supplies sit here and there in the otherwise empty space. Stairs lead up, while a doorway leads south.

>x boxes
There's nothing like that nearby.

>s
Agent Faraji is in the back basement. The basement ends here. There is a switch on the wall, currently on. A doorway leads north.

A strange glow emanates from behind some stacks of large crates.

>x glow
The glow is blue-white and flickering.

>x crates
There seems to be nothing special about them.

>move them
Those are too heavy to move unaided.

>take them
Those are too heavy to take.

>x glow
The glow is blue-white and flickering.

>turn off light
Faraji switches the light switch off.

It is now pitch dark in here!

* * *

>turn on light
Faraji switches the light switch on.

Agent Faraji is in the back basement. The basement ends here. There is a switch on the wall, currently on. A doorway leads north.

A strange glow emanates from behind some stacks of large crates.

>l
Agent Faraji is in the back basement. The basement ends here. There is a switch on the wall, currently on. A doorway leads north.

A strange glow emanates from behind some stacks of large crates.

>rules
Rules tracing now switched on. Type "rules off" to switch it off again, or "rules all" to include even rules which do not apply.

[Rule "clear LPR rule" applies.]
[Rule "reset skip sounds rule" applies.]

* * *

>turn off light
Faraji switches the light switch off.

It is now pitch dark in here!

>wear lenses
Faraji puts on the pair of astral lenses.

Agent Faraji is in the back basement. The basement ends here. There is a switch on the wall, currently off. A doorway leads north.

A strange glow emanates from behind some stacks of large crates.

A hyperspatial tunnel leads in the direction of "forth".

>f
Agent Faraji is in the astral tunnel. It is featureless white, or what passes for white here. It bends "back" to "forthnorth."

>fn
Agent Faraji is in the laundromat. Dingy machines line the walls. A doorway leads west.

A hyperspatial tunnel leads in the direction of "backsouth".

Also here is a handtruck.

>bs
Agent Faraji is in the astral tunnel. It is featureless white, or what passes for white here. It bends "back" to "forthnorth."

>b
Agent Faraji is in the back basement. The basement ends here. There is a switch on the wall, currently off. A doorway leads north.

A strange glow emanates from behind some stacks of large crates.

A hyperspatial tunnel leads in the direction of "forth".

>gonear utility closet
Agent Faraji is in the utility closet.

>l
Agent Faraji is in the utility closet.

>i
Faraji is carrying:
  a pair of astral lenses (being worn)
  the Bureau credit card

>remove lenses
Faraji takes off the pair of astral lenses.

It is now pitch dark in here!

>knock
What do you want to knock?

>x door
There's nothing like that nearby.

>wear lenses
Faraji puts on the pair of astral lenses.

Agent Faraji is in the utility closet.

>x door
There seems to be nothing special about it.

>knock on it
After a few seconds, someone inserts a key in the lock and opens the door. It's Faraji's colleague Moira Zin. "How'd you get in there, Larch?"

You exit the closet.

Agent Faraji is in Moira's office. It is, like Moira herself, neat and orderly. She's clearly made the most of the meager funds she had for furnishing her office. Behind a modest yet functional desk is a modest yet functional office chair. Her bookshelves are filled with titles relating to investigative techniques, law, and skepticism. In the east wall is a closet door. The exit is to the south.

On Moira's bookshelves is Native Tribes of Upstate New York.

Also here is Moira Zin.

A phone is ringing not too far away.

Faraji can tell Moira Zin about the hyperdimensional portal or tell Moira Zin to wait for the report.

>ask zin about the portal
1.

2.

A phone is ringing not too far away.

>l
Agent Faraji is in Moira's office. It is, like Moira herself, neat and orderly. She's clearly made the most of the meager funds she had for furnishing her office. Behind a modest yet functional desk is a modest yet functional office chair. Her bookshelves are filled with titles relating to investigative techniques, law, and skepticism. In the east wall is a closet door. The exit is to the south.

On Moira's bookshelves is Native Tribes of Upstate New York.

Also here is Moira Zin.

A phone is ringing not too far away.

>read native
There seems to be nothing special about it.

A phone is ringing not too far away.

>x shelves
FILL THIS IN

On Moira's bookshelves is Native Tribes of Upstate New York.

A phone is ringing not too far away.

>s
(first opening Moira's door)
Agent Faraji is in the hallway. Their office is to the south, Klimp's is to the west, and Moira's is to the north. The front office is east.

A phone is ringing to the south, in Faraji's office.

* * *

>wear lenses
Faraji puts on the pair of astral lenses.

Agent Faraji is in the back basement. The basement ends here. There is a switch on the wall, currently off. A doorway leads north.

A strange glow emanates from behind some stacks of large crates.

A hyperspatial tunnel leads in the direction of "forth".

>remove them
Faraji takes off the pair of astral lenses.

It is now pitch dark in here!

>ask about lenses
Chief Klimp isn't here.

>l
Agent Faraji is in the dark. Some light would be nice.

There is a glow-in-the-dark light switch on the wall here, currently off.

There is a strange glow emanating from behind some large dark objects.

>wear lenses
Faraji puts on the pair of astral lenses.

Agent Faraji is in the back basement. The basement ends here. There is a switch on the wall, currently off. A doorway leads north.

A strange glow emanates from behind some stacks of large crates.

A hyperspatial tunnel leads in the direction of "forth".

* * *

>fn
Agent Faraji is in the laundromat. Dingy machines line the walls. A doorway leads west.

A hyperspatial tunnel leads in the direction of "backsouth".

Also here is a handtruck.

>push truck w
Agent Faraji is in the laundromat back room. A desk sits in the corner covered with paperwork. A doorway leads east to the laundromat proper, while a steep set of stairs leads down.

A hyperspatial tunnel leads in the direction of "back".

>push truck d
The stairs are much too steep to maneuver the handtruck down them.

>push truck e
Agent Faraji is in the laundromat. Dingy machines line the walls. A doorway leads west.

A hyperspatial tunnel leads in the direction of "backsouth".

>push it bs
Agent Faraji is in the astral tunnel. It is featureless white, or what passes for white here. It bends "back" to "forthnorth."

>push it b
Agent Faraji is in the back basement. The basement ends here. There is a switch on the wall, currently off. A doorway leads north.

A strange glow emanates from behind some stacks of large crates.

A hyperspatial tunnel leads in the direction of "forth".

>move stacks
Those are too heavy to move unaided.

>move stacks with truck
You move the crates out of the way and uncover an old front-loading washing machine. There is a strange glow inside the drum.

>x machine
It's a front-loading model. The inside of the drum is obscured by a shimmering curtain of light.

>open it
Faraji opens the broken washing machine.

>enter it
There is a flash of light and Faraji finds themself somewhere else...

Agent Faraji is on a featureless hyperplane. They rub their eyes as they try to take in their surroundings. In addition to the usual directions of north and south and east and west, two new directions exist here: back and forth. As a result, the "surface" they're standing on is in fact a three-dimensional hyperplane. Up and down still exist, and there is gravity, apparently.

As far as one can see, the hyperplane extends infinitely in all six directions.

In the middle distance is some kind of structure, roughly to the forth.

>f
Agent Faraji is on a featureless hyperplane. In addition to the usual directions of north and south and east and west, two new directions exist here: back and forth. As a result, the "surface" they're standing on is in fact a three-dimensional hyperplane. Up and down still exist, and there is gravity, apparently.

As far as one can see, the hyperplane extends infinitely in all six directions.

In the middle distance is some kind of structure, roughly to the forth.

* * *

>take compass
Taken.

>x it
On the readout of the mystic compass floats a set of ethereal symbols:  :  :

>s
Agent Faraji is on a featureless hyperplane. In addition to the usual directions of north and south and east and west, two new directions exist here: back and forth. As a result, the "surface" they're standing on is in fact a three-dimensional hyperplane. Up and down still exist, and there is gravity, apparently.

As far as one can see, the hyperplane extends infinitely in all six directions.

On the readout of the mystic compass floats a set of ethereal symbols:  :  : 

Close by is some kind of structure to the north.

>s
Agent Faraji is on a featureless hyperplane. In addition to the usual directions of north and south and east and west, two new directions exist here: back and forth. As a result, the "surface" they're standing on is in fact a three-dimensional hyperplane. Up and down still exist, and there is gravity, apparently.

As far as one can see, the hyperplane extends infinitely in all six directions.

On the readout of the mystic compass floats a set of ethereal symbols:  :  : 

Not too far off is some kind of structure, roughly to the north.

>s
Agent Faraji is on a featureless hyperplane. In addition to the usual directions of north and south and east and west, two new directions exist here: back and forth. As a result, the "surface" they're standing on is in fact a three-dimensional hyperplane. Up and down still exist, and there is gravity, apparently.

As far as one can see, the hyperplane extends infinitely in all six directions.

On the readout of the mystic compass floats a set of ethereal symbols:  :  : 

Not too far off is some kind of structure, roughly to the north.

>e
Agent Faraji is on a featureless hyperplane. In addition to the usual directions of north and south and east and west, two new directions exist here: back and forth. As a result, the "surface" they're standing on is in fact a three-dimensional hyperplane. Up and down still exist, and there is gravity, apparently.

As far as one can see, the hyperplane extends infinitely in all six directions.

On the readout of the mystic compass floats a set of ethereal symbols:  :  : 

Not too far off is some kind of structure, roughly to the north.

>e
Agent Faraji is on a featureless hyperplane. In addition to the usual directions of north and south and east and west, two new directions exist here: back and forth. As a result, the "surface" they're standing on is in fact a three-dimensional hyperplane. Up and down still exist, and there is gravity, apparently.

As far as one can see, the hyperplane extends infinitely in all six directions.

On the readout of the mystic compass floats a set of ethereal symbols:  :  : 

Not too far off is some kind of structure, roughly to the north.

>e
Agent Faraji is on a featureless hyperplane. In addition to the usual directions of north and south and east and west, two new directions exist here: back and forth. As a result, the "surface" they're standing on is in fact a three-dimensional hyperplane. Up and down still exist, and there is gravity, apparently.

As far as one can see, the hyperplane extends infinitely in all six directions.

On the readout of the mystic compass floats a set of ethereal symbols:  :  : 

Not too far off is some kind of structure, roughly to the northwest.

>e
Agent Faraji is on a featureless hyperplane. In addition to the usual directions of north and south and east and west, two new directions exist here: back and forth. As a result, the "surface" they're standing on is in fact a three-dimensional hyperplane. Up and down still exist, and there is gravity, apparently.

As far as one can see, the hyperplane extends infinitely in all six directions.

On the readout of the mystic compass floats a set of ethereal symbols:  :  : 

Not too far off is some kind of structure, roughly to the northwest.

>e
Agent Faraji is on a featureless hyperplane. In addition to the usual directions of north and south and east and west, two new directions exist here: back and forth. As a result, the "surface" they're standing on is in fact a three-dimensional hyperplane. Up and down still exist, and there is gravity, apparently.

As far as one can see, the hyperplane extends infinitely in all six directions.

On the readout of the mystic compass floats a set of ethereal symbols:  :  : 

In the middle distance is some kind of structure, roughly to the northwest.

>e
Agent Faraji is on a featureless hyperplane. In addition to the usual directions of north and south and east and west, two new directions exist here: back and forth. As a result, the "surface" they're standing on is in fact a three-dimensional hyperplane. Up and down still exist, and there is gravity, apparently.

As far as one can see, the hyperplane extends infinitely in all six directions.

On the readout of the mystic compass floats a set of ethereal symbols:  :  : 

In the middle distance is some kind of structure, roughly to the northwest.

>b
Agent Faraji is on a featureless hyperplane. In addition to the usual directions of north and south and east and west, two new directions exist here: back and forth. As a result, the "surface" they're standing on is in fact a three-dimensional hyperplane. Up and down still exist, and there is gravity, apparently.

As far as one can see, the hyperplane extends infinitely in all six directions.

On the readout of the mystic compass floats a set of ethereal symbols:  :  : 

In the middle distance is some kind of structure, roughly to the northwest.

* * *

>d
Agent Faraji is at field office reception. Hooray you made it!

Also here is Maggie.

>ask about maggie
That doesn't seem to be a topic of conversation at the moment.

>u
Agent Faraji is at the top of a descending stair. It is made of the same gossamer, questionably real stuff as the ground, the pillar, and the readouts. You can't see past the first turn of the stairs, unfortunately.

On the readout of the mystic compass floats a set of ethereal symbols:  :  : 

In the middle distance is some kind of structure, roughly to the forthnorth.

>e
Agent Faraji is on a featureless hyperplane. In addition to the usual directions of north and south and east and west, two new directions exist here: back and forth. As a result, the "surface" they're standing on is in fact a three-dimensional hyperplane. Up and down still exist, and there is gravity, apparently.

As far as one can see, the hyperplane extends infinitely in all six directions.

On the readout of the mystic compass floats a set of ethereal symbols:  :  : 

In the middle distance is some kind of structure, roughly to the forthnorth.

>w
Agent Faraji is at the top of a descending stair. It is made of the same gossamer, questionably real stuff as the ground, the pillar, and the readouts. You can't see past the first turn of the stairs, unfortunately.

On the readout of the mystic compass floats a set of ethereal symbols:  :  : 

In the middle distance is some kind of structure, roughly to the forthnorth.

>d
Agent Faraji is at field office reception. Hooray you made it!

Also here is Maggie.

* * *

>ask about klimp
Where's the Chief?"

Margaret points towards the hall. "He's in his office."

A phone is ringing not too far away.

Faraji can ask for a screwdriver or ask about-the-phone-exchange.

>ask margaret about klimp
That doesn't seem to be a topic of conversation at the moment.

A phone is ringing not too far away.

Faraji can ask for a screwdriver or ask what's up with the phone.

>actions
Actions listing on.

>ask about klimp
[implicit-quizzing Chief Klimp]
[(1) quizzing Margaret about Chief Klimp]
That doesn't seem to be a topic of conversation at the moment.
[(1) quizzing Margaret about Chief Klimp - succeeded]

[implicit-quizzing Chief Klimp - failed]

A phone is ringing not too far away.

Faraji can ask for a screwdriver or ask what's up with the phone.

>rules
Rules tracing now switched on. Type "rules off" to switch it off again, or "rules all" to include even rules which do not apply.

[Rule "clear LPR rule" applies.]
[Rule "reset skip sounds rule" applies.]

* * *

>w
Faraji extricates themself from talking with Margaret.

Agent Faraji is in the hallway. Their office is to the south, Klimp's is to the west, and Moira's is to the north. The front office is east.

A phone is ringing to the south.

>s
Agent Faraji is in their office. They pause and survey the scene. It's not much -- four white walls, grey industrial carpet. Margaret has helpfully assembled Faraji's desk and chair, though how sturdily is an open question. She also took the time to put up some of Agent Faraji's office decor -- their degree in Nonstandard Investigative Techniques, an original pencil drawing of the Pitfall snake by semi-acclaimed Washington DC artist Darius 5200, and a photo of their soccer team. At the very least the wall coverings help compensate for the lack of windows. There's a disconnected landline on the desk. The office door is to the north, and there's a white metal door to the west.

Faraji mutters, "Where's my computer?"

A phone is ringing inside their desk.

>n
Agent Faraji is in the hallway. Their office is to the south, Klimp's is to the west, and Moira's is to the north. The front office is east.

A phone is ringing to the south, in their office.

>e
Agent Faraji is in the front office. It's really a small storefront done up to resemble an office. A store sales counter serves as a front desk, behind which are located shelves of office supplies and a row of drawers. There are also a couch and coffee table here creating a makeshift seating area. An old department store clothing rack serves as a coatrack. Photos on the walls picture the Bureau in better days. A stack of used and empty cardboard boxes sits in one corner.

The Bureau's latest office manager, Margaret is bustling around with unrestrained enthusiasm.

A phone is ringing somewhere else not too far away.

Faraji can ask about the status of the computer or ask about the phone exchange.

(talking to Margaret)

>gonear klimp
Agent Faraji is in the Room of Stuff. 

Also here are Moira Zin, Chief Klimp, Faraji's former self, a thumb drive, a blue screwdriver, Ezra Gaunt, Petula Goldberg, Senator Savra, finding the drive, some flattened boxes and some flattened boxes.

Faraji can ask about the status of the computer or ask about the phone exchange.

(talking to Margaret)

>hello klip
I only understood you as far as wanting to hello.

(talking to Margaret)

>hello
(addressing Ezra Gaunt)
(talking to Ezra Gaunt)

* * *

>open desk
Faraji tries to open the desk to answer the phone, but it seems to be locked. They sigh. "Margaret must have the key."

A phone is ringing inside their desk.

* * *

>sit in chair
Faraji gets onto their chair.

A phone is ringing inside their desk.

>take their chair
Faraji would have to get off their chair first.

A phone is ringing inside their desk.

>get off
Faraji gets off their chair.

Agent Faraji is in their office. It's basically four white walls and grey carpet. There's a cheap desk and chair, and a disconnected phone on the desk. In lieu of windows, there are a few things on the wall: their degree in Nonstandard Investigative Techniques, a pencil drawing of the Pitfall snake, and a photo of their soccer team. The office door is to the north, and there's a white metal door to the west.

A phone is ringing inside their desk.

>sit on chair
Faraji gets onto their chair.

A phone is ringing inside their desk.

>l
Agent Faraji is in their office. They are on their chair. It's basically four white walls and grey carpet. There's a cheap desk and chair, and a disconnected phone on the desk. In lieu of windows, there are a few things on the wall: their degree in Nonstandard Investigative Techniques, a pencil drawing of the Pitfall snake, and a photo of their soccer team. The office door is to the north, and there's a white metal door to the west.

A phone is ringing inside their desk.

>x faraji's chair
It's just a plain old office chair. The lumbar support control is broken.

A phone is ringing inside Faraji's desk.

>open desk
Faraji tries to open the desk to answer the phone, but it seems to be locked. They sigh. "Margaret must have the key."

A phone is ringing inside their desk.

>open desk
It seems to be locked.

A phone is ringing inside Faraji's desk.

>w
(first getting off Faraji's chair)
(first opening the white metal door)
It seems to be locked.

A phone is ringing inside their desk.

>x door
Which do you mean, Faraji's door or the white metal door?

>metal
An unremarkable metal door painted white. It is closed and locked.

A phone is ringing inside their desk.

>m
I'm not sure what you're trying to say. I might just not recognize the words you're using.

>n
Agent Faraji is in the hallway. Their office is to the south, Klimp's is to the west, and Moira's is to the north. The front office is east.

A phone is ringing to the south, in their office.

>e
Agent Faraji is in the front office. It's really a small storefront done up to resemble an office. A store sales counter serves as a front desk, behind which are located shelves of office supplies and a row of drawers. There are also a couch and coffee table here creating a makeshift seating area. An old department store clothing rack serves as a coatrack. Photos on the walls picture the Bureau in better days. A stack of used and empty cardboard boxes sits in one corner.

The Bureau's latest office manager, Margaret is bustling around with unrestrained enthusiasm.

A phone is ringing somewhere else not too far away.

Faraji can ask about the whereabouts of the desk key, ask about the status of the computer, ask to unlock the backdoor or ask about the phone exchange.

>unlock door
There's nothing like that nearby.

>unlock backdoor
There's nothing like that nearby.

>ask unlock backdoora
There's nothing like that nearby.

>ask unlock backdoor
Faraji asks, "Could you unlock the back door, Margaret?"

"Sorry, too busy right now. What do you want back there anyway? There's only a dumpster." She pauses for a moment and mutters to herself. "Which reminds me, I need to get these boxes broken down."

A phone is ringing somewhere else not too far away.

Faraji can ask about the whereabouts of the desk key, ask about the status of the computer or ask about the phone exchange.

>undo
front office
[Previous turn undone.]

>ask her to unlock the backdoor
Faraji asks, "Could you unlock the back door, Margaret?"

"Sorry, too busy right now. What do you want back there anyway? There's only a dumpster." She pauses for a moment and mutters to herself. "Which reminds me, I need to get these boxes broken down."

A phone is ringing somewhere else not too far away.

Faraji can ask about the whereabouts of the desk key, ask about the status of the computer or ask about the phone exchange.

>break down boxes
Faraji picks up a couple of boxes and flattens them.

Margaret says, "Hey, what are you doing with those boxes, Agent Faraji? You don't have to worry about that -- I'll get them." She takes the flattened boxes from Faraji and hustles off.

A phone is ringing somewhere else not too far away.

Margaret goes west.

>restart
Are you sure you want to restart?

>y
The Bureau of Strange Happenings
An Interactive Phenomenon by Phil Riley
Release 1 / Serial number 230616 / Inform 7 build 6M62 (I6/v6.34 lib 6/12N) SD

Agent Faraji is at the south end of the strip mall parking lot. From here one can see just how humble BOSH's state has become: the office is to the west, between a pawn shop (to the southwest) and a run-down laundromat (to the northwest) and across from an automatic car wash. To the south is a swampy area separating the lot from the interstate. The parking lot continues north.

Their Hyundai is parked nearby.

>w
Just like in the store this once was, the door chimes as Faraji walks in.

Agent Faraji is in the front office. It's really a small storefront done up to resemble an office. A store sales counter serves as a front desk, behind which are located shelves of office supplies and a row of drawers. There are also a couch and coffee table here creating a makeshift seating area. An old department store clothing rack serves as a coatrack. Photos on the walls picture the Bureau in better days. A stack of used and empty cardboard boxes sits in one corner.

The Bureau's latest office manager, Margaret is bustling around with unrestrained enthusiasm, unpacking boxes and assembling an approximation of a respectable front office, all as if the Bureau isn't going to be shut down before the year is out. She sees Faraji and practically squeals. "Agent Faraji! I'm sorry -- Larch! How are you? I hope you don't mind -- I took the liberty of putting your desk together. I just love hex wrenches, don't you? Also, your new phone is here. I put it in your desk. Now I just need you to give me your old phone so I can deactivate it."

Faraji hands Margaret their old phone. Margaret taps a few keys on her computer and says "There! All settled."

"Oh, good", Faraji says. "Our phone downgrades have arrived from our bureaucratic betters."

A phone is ringing somewhere else not too far away.

Faraji can ask about the phone exchange.

>break down boxes
Faraji picks up a couple of boxes and flattens them.

Margaret says, "Hey, what are you doing with those boxes, Agent Faraji? You don't have to worry about that -- I'll get them." She takes the flattened boxes from Faraji and hustles off.

A phone is ringing somewhere else not too far away.

Margaret goes west.

>w
Agent Faraji is in the hallway. Their office is to the south, Klimp's is to the west, and Moira's is to the north. The front office is east.

Also here is Margaret.

A phone is ringing to the south.

Margaret goes south.

* * *

>w
(first opening the white metal door)
Agent Faraji is in the back lot. This is a small area of asphalt between the building and a chain link fence looking in on an industrial property. A door to east leads into the BOSH offices, and one to the north enters the laundromat. There is a blue dumpster here.

A phone is ringing to the east, in their office.

Margaret arrives from the east.

>e
Agent Faraji is in their office. It's basically four white walls and grey carpet. There's a cheap desk and chair, and a disconnected phone on the desk. In lieu of windows, there are a few things on the wall: their degree in Nonstandard Investigative Techniques, a pencil drawing of the Pitfall snake, and a photo of their soccer team. The office door is to the north, and there's a white metal door to the west.

A phone is ringing inside their desk.

>n
Agent Faraji is in the hallway. Their office is to the south, Klimp's is to the west, and Moira's is to the north. The front office is east.

A phone is ringing to the south, in their office.

* * *

>e
Faraji steps out of the office into the parking lot.

Agent Faraji is at the south end of the strip mall parking lot. From here one can see just how humble BOSH's state has become: the office is to the west, between a pawn shop (to the southwest) and a run-down laundromat (to the northwest) and across from an automatic car wash. To the south is a swampy area separating the lot from the interstate. The parking lot continues north.

Their Hyundai is parked nearby.

>w
Agent Faraji is in the front office. It's really a small storefront done up to resemble an office. A store sales counter serves as a front desk, behind which are located shelves of office supplies and a row of drawers. There are also a couch and coffee table here creating a makeshift seating area. An old department store clothing rack serves as a coatrack. Photos on the walls picture the Bureau in better days. A stack of used and empty cardboard boxes sits in one corner.

The Bureau's latest office manager, Margaret is bustling around with unrestrained enthusiasm.

A phone is ringing somewhere else not too far away.

Faraji can ask about the status of the computer or ask about the phone exchange.

* * *

>w
Agent Faraji is in the hallway. Their office is to the south, Klimp's is to the west, and Moira's is to the north. The front office is east.

A phone is ringing to the south, in their office.

>s
Agent Faraji is in their office. It's basically four white walls and grey carpet. There's a cheap desk and chair, and a disconnected phone on the desk. In lieu of windows, there are a few things on the wall: their degree in Nonstandard Investigative Techniques, a pencil drawing of the Pitfall snake, and a photo of their soccer team. The office door is to the north, and there's a white metal door to the west.

A phone is ringing inside their desk.

>w
(first opening the white metal door)
It seems to be locked.

A phone is ringing inside Faraji's desk.

* * *

>x snake
Pencil on canvas, it's a fuzzy drawing of the 8-bit snake in the classic video game Pitfall.

A phone is ringing inside Faraji's desk.

>x 8-bit
There's nothing like that nearby.

>x video
Pencil on canvas, it's a fuzzy drawing of the 8-bit snake in the classic video game Pitfall.

A phone is ringing inside Faraji's desk.

>open desk
Faraji tries to open the desk to answer the phone, but it seems to be locked. They sigh. "Margaret must have the key."

A phone is ringing inside their desk.

>n
Agent Faraji is in the hallway. Their office is to the south, Klimp's is to the west, and Moira's is to the north. The front office is east.

A phone is ringing to the south, in their office.

>e
Agent Faraji is in the front office. It's really a small storefront done up to resemble an office. A store sales counter serves as a front desk, behind which are located shelves of office supplies and a row of drawers. There are also a couch and coffee table here creating a makeshift seating area. An old department store clothing rack serves as a coatrack. Photos on the walls picture the Bureau in better days. A stack of used and empty cardboard boxes sits in one corner.

The Bureau's latest office manager, Margaret is bustling around with unrestrained enthusiasm.

A phone is ringing somewhere else not too far away.

Faraji can ask about the whereabouts of the desk key, ask about the status of the computer or ask about the phone exchange.

>exchange
Faraji asks, "Tell me what's going on with the phones again?"

Margaret looks apologetic. "I'm sorry, I thought everyone knew. Budget cuts. They're trading in all our smart phones for cheaper models."

A phone is ringing somewhere else not too far away.

Faraji can ask about the whereabouts of the desk key or ask about the status of the computer.

>i
Faraji is carrying:
  the Bureau credit card

A phone is ringing somewhere else not too far away.

Faraji can ask about the whereabouts of the desk key or ask about the status of the computer.

>ask about computer
"Margaret", Faraji says, "what's up with my computer?"

"Oh, it got busted up during the move. I have it behind my desk -- you can see it if you want. We'll have to get you a new one."

A phone is ringing somewhere else not too far away.

Faraji can ask about the whereabouts of the desk key.

>look behind desk
There are a number of shelves of office supplies behind the desk. There is also a heating vent on the floor here.

Faraji finds their computer and pulls it out.

A phone is ringing somewhere else not too far away.

Faraji can ask about the whereabouts of the desk key.

>x vent
A typical air register with a grill which one would hope would stop things like, say, a hex wrench from falling through. It's set in the floor behind the front desk. The vent is held closed by four screws.

In the heating vent is a hex wrench.

A phone is ringing somewhere else not too far away.

Faraji can ask about the whereabouts of the desk key or ask for a screwdriver.

* * *

>x desk
The former sales counter now functions as a desk for the office manager (currently Margaret). Behind it are a number of shelves holding office supplies.

A phone is ringing somewhere else not too far away.

Faraji can ask about the phone exchange.

>look behind desk
There are a number of shelves of office supplies behind the desk. There is also a heating vent on the floor here.

Faraji finds their computer and pulls it out.

A phone is ringing somewhere else not too far away.

Faraji can ask about the phone exchange.

>enigma
Agent Faraji is in the Enigma Lake town hall. 

Faraji can ask about the phone exchange.

* * *

>x photos
The photo of Ezra Gaunt and Petula Goldberg smiling together is particularly poignant, as they were just let go last month.

A phone is ringing somewhere else not too far away.

Faraji can ask about the phone exchange.

>x margaret
Margaret is the latest occupant of the rapidly revolving post of office manager. Most of her job involves ordering stationery and office supplies, shredding documents, and keeping track of office equipment.

A phone is ringing somewhere else not too far away.

Faraji can ask about the phone exchange.

>x phone
There's nothing like that nearby.

>scope
1: Hyperlight (1098437)
2: a ceiling (1098341)
3: a floor (1098309)
4: a wall (1098277)
5: Faraji (1102501)
6: Margaret (1100325)
7: bfo-light (1100357)
8: a coffee table (1100389)
9: a couch (1100421)
10: a makeshift seating area (1100453)
11: a coatrack (1100485)
12: some Bureau photos (1100517)
13: a front desk (1100549)
14: some shelves of office supplies (1100581)
15: some cardboard boxes (1100613)
16: the Bureau credit card (1105157)

>x bfo-light
There's nothing like that nearby.

>x Faraji
Agent Faraji 

A phone is ringing somewhere else not too far away.

Faraji can ask about the phone exchange.

>l
Agent Faraji is in the front office. It's really a small storefront done up to resemble an office. A store sales counter serves as a front desk, behind which are located shelves of office supplies and a row of drawers. There are also a couch and coffee table here creating a makeshift seating area. An old department store clothing rack serves as a coatrack. Photos on the walls picture the Bureau in better days. A stack of used and empty cardboard boxes sits in one corner.

The Bureau's latest office manager, Margaret is bustling around with unrestrained enthusiasm.

A phone is ringing somewhere else not too far away.

Faraji can ask about the phone exchange.

>x area
A coffee table and couch greet visitors to the office, as if any are expected.

A phone is ringing somewhere else not too far away.

Faraji can ask about the phone exchange.

>x department
There's nothing like that nearby.

>x photos
The photo of Ezra Gaunt and Petula Goldberg smiling together is particularly poignant, as they were just let go last month.

A phone is ringing somewhere else not too far away.

Faraji can ask about the phone exchange.

>w
Faraji extricates themself from talking with Margaret.

Agent Faraji is in the hallway. Their office is to the south, Klimp's is to the west, and Moira's is to the north. The front office is east.

A phone is ringing to the south.

>n
(first opening Moira's door)
It seems to be locked.

A phone is ringing to the south.

>x moira's door
There seems to be nothing special about it.

A phone is ringing to the south.

>gonear chief's office
Which do you mean, the field office chief's office or the BOSH chief's office?

>bosh
Agent Faraji is in the BOSH chief's office. 

On the Chief's shelves are a juvenile sasquatch skull and a pair of astral lenses.

>z
Faraji stands around and waits.

>gonear bosh hallway
Agent Faraji is in the hallway. Their office is to the south, Klimp's is to the west, and Moira's is to the north. The front office is east.

A phone is ringing to the south.

>n
(first opening Moira's door)
It seems to be locked.

A phone is ringing to the south.

>s
Agent Faraji is in their office. They pause and survey the scene. It's not much -- four white walls, grey industrial carpet. Margaret has helpfully assembled Faraji's desk and chair, though how sturdily is an open question. She also took the time to put up some of Agent Faraji's office decor -- their degree in Nonstandard Investigative Techniques, an original pencil drawing of the Pitfall snake by semi-acclaimed Washington DC artist Darius 5200, and a photo of their softball team. At the very least the wall coverings help compensate for the lack of windows. There's a disconnected landline on the desk. The office door is to the north, and there's a white metal door to the west.

Faraji mutters, "Where's my computer?"

A phone is ringing inside their desk.

>sit in chair
Faraji gets onto their chair.

A phone is ringing inside their desk.

>get up
Faraji gets off their chair.

Agent Faraji is in their office. It's basically four white walls and grey carpet. There's a cheap desk and chair, and a disconnected phone on the desk. In lieu of windows, there are a few things on the wall: their degree in Nonstandard Investigative Techniques, a pencil drawing of the Pitfall snake, and a photo of their softball team. The office door is to the north, and there's a white metal door to the west.

A phone is ringing inside their desk.

>x faraji's chair
It's just a plain old office chair. The lumbar support control is broken.

A phone is ringing inside Faraji's desk.

>x desk
The desk is a cheap DIY piece held together with hex screws. It has a single drawer which is closed.

A phone is ringing inside Faraji's desk.

>w
(first opening the white metal door)
It seems to be locked.

A phone is ringing inside Faraji's desk.

* * *

>n
Agent Faraji is in the hallway. Their office is to the south, Klimp's is to the west, and Moira's is to the north. The front office is east.

A phone is ringing to the south, in their office.

>n
(first opening Moira's door)
It seems to be locked.

A phone is ringing to the south, in Faraji's office.

>w
(first opening Klimp's door)
It seems to be locked.

A phone is ringing to the south, in Faraji's office.

>e
Agent Faraji is in the front office. It's really a small storefront done up to resemble an office. A store sales counter serves as a front desk, behind which are located shelves of office supplies and a row of drawers. There are also a couch and coffee table here creating a makeshift seating area. An old department store clothing rack serves as a coatrack. Photos on the walls picture the Bureau in better days. A stack of used and empty cardboard boxes sits in one corner.

The Bureau's latest office manager, Margaret is bustling around with unrestrained enthusiasm.

A phone is ringing somewhere else not too far away.

Faraji can ask about the status of the computer, ask to unlock the backdoor or ask about the phone exchange.

>w
Agent Faraji is in the hallway. Their office is to the south, Klimp's is to the west, and Moira's is to the north. The front office is east.

A phone is ringing to the south, in their office.

>s
Agent Faraji is in their office. It's basically four white walls and grey carpet. There's a cheap desk and chair, and a disconnected phone on the desk. In lieu of windows, there are a few things on the wall: their degree in Nonstandard Investigative Techniques, a pencil drawing of the Pitfall snake, and a photo of their softball team. The office door is to the north, and there's a white metal door to the west.

A phone is ringing inside their desk.

>l
Agent Faraji is in their office. It's basically four white walls and grey carpet. There's a cheap desk and chair, and a disconnected phone on the desk. In lieu of windows, there are a few things on the wall: their degree in Nonstandard Investigative Techniques, a pencil drawing of the Pitfall snake, and a photo of their softball team. The office door is to the north, and there's a white metal door to the west.

A phone is ringing inside their desk.

* * *

>x storefront
Agent Faraji is in the front office. It's really a small storefront done up to resemble an office. A store sales counter serves as a front desk, behind which are located shelves of office supplies and a row of drawers. There are also a couch and coffee table here creating a makeshift seating area. An old department store clothing rack serves as a coatrack. Photos on the walls picture the Bureau in better days. A stack of used and empty cardboard boxes sits in one corner.

The Bureau's latest office manager, Margaret is bustling around with unrestrained enthusiasm.

A phone is ringing not too far away.

Faraji can ask about the phone exchange.

>x front office
Agent Faraji is in the front office. It's really a small storefront done up to resemble an office. A store sales counter serves as a front desk, behind which are located shelves of office supplies and a row of drawers. There are also a couch and coffee table here creating a makeshift seating area. An old department store clothing rack serves as a coatrack. Photos on the walls picture the Bureau in better days. A stack of used and empty cardboard boxes sits in one corner.

The Bureau's latest office manager, Margaret is bustling around with unrestrained enthusiasm.

A phone is ringing not too far away.

>x sales counter
The former sales counter now functions as a desk for the office manager (currently Margaret). Behind it are a number of shelves holding office supplies.

A phone is ringing not too far away.

>x desl
There's nothing like that nearby.

>x desk
The former sales counter now functions as a desk for the office manager (currently Margaret). Behind it are a number of shelves holding office supplies.

A phone is ringing not too far away.

>x couch
Apparently the bureau did make off with at least one piece of government furniture. A bland, institutional piece with fake leather seats, it's at least preferable to second-hand upholstery.

A phone is ringing not too far away.

>x furniture
There's nothing like that nearby.

>x table
This doesn't look like government-issue furniture. More like thrift store. It's scuffed, but at least it's sturdy.

A phone is ringing not too far away.

>ask about table
Faraji says, "Tell me about the coffee table, Margaret."

"It's not much, but what can you expect for $8?

A phone is ringing not too far away.

* * *

>x office
(the shelves of office supplies)
Pens, paper, nothing Faraji's really concerned with now.

A phone is ringing not too far away.

Faraji can ask about the phone exchange.

>x counter
The former sales counter now functions as a desk for the office manager (currently Margaret). Behind it are a number of shelves holding office supplies.

A phone is ringing not too far away.

Faraji can ask about the phone exchange.

>x desk
The former sales counter now functions as a desk for the office manager (currently Margaret). Behind it are a number of shelves holding office supplies.

A phone is ringing not too far away.

Faraji can ask about the phone exchange.

>x chelves
There's nothing like that nearby.

>x pens
Pens, paper, nothing Faraji's really concerned with now.

A phone is ringing not too far away.

Faraji can ask about the phone exchange.

>x paper
Pens, paper, nothing Faraji's really concerned with now.

A phone is ringing not too far away.

Faraji can ask about the phone exchange.

>x pencil
Pens, paper, nothing Faraji's really concerned with now.

A phone is ringing not too far away.

Faraji can ask about the phone exchange.

>x shelves
Pens, paper, nothing Faraji's really concerned with now.

A phone is ringing not too far away.

Faraji can ask about the phone exchange.

>l
Agent Faraji is in the front office. It's really a small storefront done up to resemble an office. A store sales counter serves as a front desk, behind which are located shelves of office supplies and a row of drawers. There are also a couch and coffee table here creating a makeshift seating area. An old department store clothing rack serves as a coatrack. Photos on the walls picture the Bureau in better days. A stack of used and empty cardboard boxes sits in one corner.

The Bureau's latest office manager, Margaret is bustling around with unrestrained enthusiasm.

A phone is ringing not too far away.

Faraji can ask about the phone exchange.

>x sales
The former sales counter now functions as a desk for the office manager (currently Margaret). Behind it are a number of shelves holding office supplies.

A phone is ringing not too far away.

Faraji can ask about the phone exchange.

>x row
Pens, paper, nothing Faraji's really concerned with now.

A phone is ringing not too far away.

Faraji can ask about the phone exchange.

>x couch
Apparently the bureau did make off with at least one piece of government furniture. A bland, institutional piece with fake leather seats, it's at least preferable to second-hand upholstery.

A phone is ringing not too far away.

Faraji can ask about the phone exchange.

>x sofa
Apparently the bureau did make off with at least one piece of government furniture. A bland, institutional piece with fake leather seats, it's at least preferable to second-hand upholstery.

A phone is ringing not too far away.

Faraji can ask about the phone exchange.

>x seats
There's nothing like that nearby.

>l
Agent Faraji is in the front office. It's really a small storefront done up to resemble an office. A store sales counter serves as a front desk, behind which are located shelves of office supplies and a row of drawers. There are also a couch and coffee table here creating a makeshift seating area. An old department store clothing rack serves as a coatrack. Photos on the walls picture the Bureau in better days. A stack of used and empty cardboard boxes sits in one corner.

The Bureau's latest office manager, Margaret is bustling around with unrestrained enthusiasm.

A phone is ringing not too far away.

Faraji can ask about the phone exchange.

>x coffee
This doesn't look like government-issue furniture. More like thrift store. It's scuffed, but at least it's sturdy.

A phone is ringing not too far away.

Faraji can ask about the phone exchange.

>x table
This doesn't look like government-issue furniture. More like thrift store. It's scuffed, but at least it's sturdy.

A phone is ringing not too far away.

Faraji can ask about the phone exchange.

>x seating area
A coffee table and couch greet visitors to the office, as if any are expected.

A phone is ringing not too far away.

Faraji can ask about the phone exchange.

>x makeshift
A coffee table and couch greet visitors to the office, as if any are expected.

A phone is ringing not too far away.

Faraji can ask about the phone exchange.

>x rack
It's an old clothing rack from the department store which formerly occupied this space.

A phone is ringing not too far away.

Faraji can ask about the phone exchange.

>x clothing
It's an old clothing rack from the department store which formerly occupied this space.

A phone is ringing not too far away.

Faraji can ask about the phone exchange.

>x coat
It's an old clothing rack from the department store which formerly occupied this space.

A phone is ringing not too far away.

Faraji can ask about the phone exchange.

>l
Agent Faraji is in the front office. It's really a small storefront done up to resemble an office. A store sales counter serves as a front desk, behind which are located shelves of office supplies and a row of drawers. There are also a couch and coffee table here creating a makeshift seating area. An old department store clothing rack serves as a coatrack. Photos on the walls picture the Bureau in better days. A stack of used and empty cardboard boxes sits in one corner.

The Bureau's latest office manager, Margaret is bustling around with unrestrained enthusiasm.

A phone is ringing not too far away.

Faraji can ask about the phone exchange.

>x photos
The photo of Ezra Gaunt and Petula Goldberg smiling together is particularly poignant, as they were just let go last month.

A phone is ringing not too far away.

Faraji can ask about the phone exchange.

>l
Agent Faraji is in the front office. It's really a small storefront done up to resemble an office. A store sales counter serves as a front desk, behind which are located shelves of office supplies and a row of drawers. There are also a couch and coffee table here creating a makeshift seating area. An old department store clothing rack serves as a coatrack. Photos on the walls picture the Bureau in better days. A stack of used and empty cardboard boxes sits in one corner.

The Bureau's latest office manager, Margaret is bustling around with unrestrained enthusiasm.

A phone is ringing not too far away.

Faraji can ask about the phone exchange.

>rules
Rules tracing now switched on. Type "rules off" to switch it off again, or "rules all" to include even rules which do not apply.

[Rule "clear LPR rule" applies.]
[Rule "reset skip sounds rule" applies.]

* * *

>x photos
The photo of Ezra Gaunt and Petula Goldberg smiling together is particularly poignant, as they were just let go last month.

A phone is ringing not too far away.

Faraji can ask about the phone exchange.

>x gaunt
There's nothing like that nearby.

>x boxes
There is a stack of boxes in the corner.

A phone is ringing not too far away.

Faraji can ask about the phone exchange.

>x boxes
There is a stack of boxes in the corner.

A phone is ringing not too far away.

Faraji can ask about the phone exchange.

>flatten box
Faraji picks up a couple of boxes and flattens them.

Margaret says, "Hey, what are you doing with those boxes, Agent Faraji? You don't have to worry about that -- I'll get them." She takes the flattened boxes from Faraji and hustles off.

A phone is ringing not too far away.

Margaret goes west.

>w
Agent Faraji is in the hallway. Their office is to the south, Klimp's is to the west, and Moira's is to the north. The front office is east.

Also here is Margaret.

A phone is ringing to the south.

Margaret goes south.

>s
Agent Faraji is in their office. 

Also here is Margaret.

A phone is ringing inside Faraji's desk.

Margaret unlocks the white metal door.

Faraji can ask about the status of the computer or ask about the phone exchange.

>w
(first opening the white metal door)
Agent Faraji is in the back lot. This is a small area of asphalt between the building and a chain link fence looking in on an industrial property. A door to east leads into the BOSH offices, and one to the north enters the laundromat. There is a blue dumpster here.

A phone is ringing to the east, in their office.

Margaret arrives from the east.

>z
Faraji stands around and waits.

A phone is ringing to the east, in their office.

Margaret tosses the flattened boxes over the edge of the dumpster.

>z
Faraji stands around and waits.

A phone is ringing to the east, in their office.

Margaret goes east.

>z
Faraji stands around and waits.

A phone is ringing to the east, in their office.

The white metal door closes.

>e
(first opening the white metal door)
It seems to be locked.

>knock on door
Which do you mean, the white metal door or the laundromat back door?

>white
The white metal door opens.

You hear the door being unlocked, and then Margaret pops her head out. "Seriously, Agent Faraji? You got yourself locked out? Be more careful!"

A phone is ringing to the east, in Faraji's office.

>e
Agent Faraji is in their office. 

Also here is Margaret.

A phone is ringing inside Faraji's desk.

Faraji can ask about the status of the computer, ask to unlock the backdoor or ask about the phone exchange.

>z
Faraji stands around and waits.

A phone is ringing inside their desk.

Margaret closes the white metal door.

Margaret locks the white metal door.

Faraji can ask about the status of the computer, ask to unlock the backdoor or ask about the phone exchange.

>n
Agent Faraji is in the hallway. Their office is to the south, Klimp's is to the west, and Moira's is to the north. The front office is east.

A phone is ringing to the south, in their office.

Margaret arrives from the south.

>e
Agent Faraji is in the front office. It's really a small storefront done up to resemble an office. A store sales counter serves as a front desk, behind which are located shelves of office supplies and a row of drawers. There are also a couch and coffee table here creating a makeshift seating area. An old department store clothing rack serves as a coatrack. Photos on the walls picture the Bureau in better days. A stack of used and empty cardboard boxes sits in one corner.

A phone is ringing not too far away.

Margaret arrives from the west.

Faraji can ask about the status of the computer, ask to unlock the backdoor or ask about the phone exchange.

>undo
hallway
[Previous turn undone.]

>undo
Faraji's office
[Previous turn undone.]

>n
Agent Faraji is in the hallway. Their office is to the south, Klimp's is to the west, and Moira's is to the north. The front office is east.

A phone is ringing to the south, in their office.

Margaret arrives from the south.

* * *

>unlock door
There's nothing like that nearby.

* * *

>unlock backdoor
There's nothing like that nearby.

>ask to unlock the backdoor
Faraji asks, "Could you unlock the back door, Margaret?"

"Sorry, too busy right now. What do you want back there anyway? There's only a dumpster." She pauses for a moment and mutters to herself. "Which reminds me, I need to get these boxes broken down."

A phone is ringing not too far away.

Faraji can ask about the status of the computer or ask about the phone exchange.

>ask about exchange
Faraji asks, "Tell me what's going on with the phones again?"

Margaret looks apologetic. "I'm sorry, I thought everyone knew. Budget cuts. They're trading in all our smart phones for cheaper models."

A phone is ringing not too far away.

Faraji can ask about the status of the computer.

>status
"Margaret", Faraji says, "what's up with my computer?"

"Oh, it got busted up during the move. I have it behind my desk -- you can see it if you want. We'll have to get you a new one."

A phone is ringing not too far away.

>hit margaret
Violence isn't the answer to this one.

A phone is ringing not too far away.

* * *

>x interstate
A ways off past the swamp, the highway carries most travelers right past this glum little village.

>closet
Agent Faraji is in the dark. 

Some light would be nice.

>z
Faraji stands around and waits.

>knock on door
There's nothing like that nearby.

>wear lenses
There's nothing like that nearby.

>lens
Agent Faraji is in the utility closet.

* * *

>knock on door
After a few seconds, someone inserts a key in the lock and opens the door. It's Faraji's colleague Moira Zin. "How'd you get in there, Larch?"

Faraji exits the closet.

Agent Faraji is in Moira's office. 

On Moira's bookshelves is Native Tribes of Upstate New York.

Also here is Moira Zin.

A phone is ringing somewhere else not too far away.

Wearing the astral lenses in fluorescent light is blinding. Faraji quickly removes the glasses.

Faraji can tell Moira Zin about the hyperdimensional portal or tell Moira Zin to wait for the report.

(talking to Moira Zin)

>e
Agent Faraji is in the dark. 

Some light would be nice.

A phone is ringing faintly somewhere else.

>e
Faraji can't go that way.

A phone is ringing faintly somewhere else.

>z
Faraji stands around and waits.

A phone is ringing faintly somewhere else.

>lens
A phone is ringing faintly somewhere else.

Agent Faraji is in the utility closet.

>remove lenses
Faraji takes off the pair of astral lenses.

A phone is ringing faintly somewhere else.

It is now pitch dark in here!

* * *

>x sky
There's nothing up there but sky.

>x ground
Black asphalt.

>x floor
Black asphalt.

>x ceiling
There's nothing up there but sky.

>look up
There's nothing up there but sky.

>look down
Black asphalt.

>look west
Faraji sees nothing unexpected in that direction.

>look north
Faraji sees nothing unexpected in that direction.

>look east
Faraji sees nothing unexpected in that direction.

>look sw
Faraji sees nothing unexpected in that direction.

>u
Faraji can neither climb walls nor fly.

>d
Faraji can't just dig downward.